county,precinct,office,district,party,candidate,votes,early_voting,election_day,provisional
Hartley,101,REGISTERED VOTERS - TOTAL,,,REGISTERED VOTERS - TOTAL,0,0,0,0
Hartley,102,REGISTERED VOTERS - TOTAL,,,REGISTERED VOTERS - TOTAL,0,0,0,0
Hartley,201,REGISTERED VOTERS - TOTAL,,,REGISTERED VOTERS - TOTAL,0,0,0,0
Hartley,202,REGISTERED VOTERS - TOTAL,,,REGISTERED VOTERS - TOTAL,0,0,0,0
Hartley,301,REGISTERED VOTERS - TOTAL,,,REGISTERED VOTERS - TOTAL,0,0,0,0
Hartley,401,REGISTERED VOTERS - TOTAL,,,REGISTERED VOTERS - TOTAL,0,0,0,0
Hartley,101,BALLOTS CAST - TOTAL,,,BALLOTS CAST - TOTAL,137,34,103,0
Hartley,102,BALLOTS CAST - TOTAL,,,BALLOTS CAST - TOTAL,71,28,43,0
Hartley,201,BALLOTS CAST - TOTAL,,,BALLOTS CAST - TOTAL,104,34,70,0
Hartley,202,BALLOTS CAST - TOTAL,,,BALLOTS CAST - TOTAL,184,76,108,0
Hartley,301,BALLOTS CAST - TOTAL,,,BALLOTS CAST - TOTAL,337,139,198,0
Hartley,401,BALLOTS CAST - TOTAL,,,BALLOTS CAST - TOTAL,281,122,159,0
Hartley,101,Straight Party,,REP,REPUBLICAN PARTY,81,16,65,0
Hartley,102,Straight Party,,REP,REPUBLICAN PARTY,36,11,25,0
Hartley,201,Straight Party,,REP,REPUBLICAN PARTY,60,17,43,0
Hartley,202,Straight Party,,REP,REPUBLICAN PARTY,95,36,59,0
Hartley,301,Straight Party,,REP,REPUBLICAN PARTY,169,75,94,0
Hartley,401,Straight Party,,REP,REPUBLICAN PARTY,132,63,69,0
Hartley,101,Straight Party,,DEM,DEMOCRATIC PARTY,5,1,4,0
Hartley,102,Straight Party,,DEM,DEMOCRATIC PARTY,1,0,1,0
Hartley,201,Straight Party,,DEM,DEMOCRATIC PARTY,3,0,3,0
Hartley,202,Straight Party,,DEM,DEMOCRATIC PARTY,1,1,0,0
Hartley,301,Straight Party,,DEM,DEMOCRATIC PARTY,8,4,4,0
Hartley,401,Straight Party,,DEM,DEMOCRATIC PARTY,7,2,5,0
Hartley,101,Straight Party,,LIB,LIBERTARIAN PARTY,0,0,0,0
Hartley,102,Straight Party,,LIB,LIBERTARIAN PARTY,1,0,1,0
Hartley,201,Straight Party,,LIB,LIBERTARIAN PARTY,0,0,0,0
Hartley,202,Straight Party,,LIB,LIBERTARIAN PARTY,1,0,1,0
Hartley,301,Straight Party,,LIB,LIBERTARIAN PARTY,0,0,0,0
Hartley,401,Straight Party,,LIB,LIBERTARIAN PARTY,1,0,1,0
Hartley,101,Straight Party,,GRN,GREEN PARTY,0,0,0,0
Hartley,102,Straight Party,,GRN,GREEN PARTY,0,0,0,0
Hartley,201,Straight Party,,GRN,GREEN PARTY,1,0,1,0
Hartley,202,Straight Party,,GRN,GREEN PARTY,0,0,0,0
Hartley,301,Straight Party,,GRN,GREEN PARTY,0,0,0,0
Hartley,401,Straight Party,,GRN,GREEN PARTY,0,0,0,0
Hartley,101,Straight Party,,,OVER VOTES,0,0,0,0
Hartley,102,Straight Party,,,OVER VOTES,0,0,0,0
Hartley,201,Straight Party,,,OVER VOTES,0,0,0,0
Hartley,202,Straight Party,,,OVER VOTES,0,0,0,0
Hartley,301,Straight Party,,,OVER VOTES,0,0,0,0
Hartley,401,Straight Party,,,OVER VOTES,0,0,0,0
Hartley,101,Straight Party,,,UNDER VOTES,51,17,34,0
Hartley,102,Straight Party,,,UNDER VOTES,33,17,16,0
Hartley,201,Straight Party,,,UNDER VOTES,40,17,23,0
Hartley,202,Straight Party,,,UNDER VOTES,87,39,48,0
Hartley,301,Straight Party,,,UNDER VOTES,160,60,100,0
Hartley,401,Straight Party,,,UNDER VOTES,141,57,84,0
Hartley,101,U.S. Senate,,REP,John Cornyn,123,28,95,0
Hartley,102,U.S. Senate,,REP,John Cornyn,66,28,38,0
Hartley,201,U.S. Senate,,REP,John Cornyn,92,32,60,0
Hartley,202,U.S. Senate,,REP,John Cornyn,171,70,101,0
Hartley,301,U.S. Senate,,REP,John Cornyn,311,130,181,0
Hartley,401,U.S. Senate,,REP,John Cornyn,241,104,137,0
Hartley,101,U.S. Senate,,DEM,David M. Alameel,12,5,7,0
Hartley,102,U.S. Senate,,DEM,David M. Alameel,5,0,5,0
Hartley,201,U.S. Senate,,DEM,David M. Alameel,5,2,3,0
Hartley,202,U.S. Senate,,DEM,David M. Alameel,8,3,5,0
Hartley,301,U.S. Senate,,DEM,David M. Alameel,17,6,11,0
Hartley,401,U.S. Senate,,DEM,David M. Alameel,28,12,16,0
Hartley,101,U.S. Senate,,LIB,Rebecca Paddock,2,1,1,0
Hartley,102,U.S. Senate,,LIB,Rebecca Paddock,0,0,0,0
Hartley,201,U.S. Senate,,LIB,Rebecca Paddock,3,0,3,0
Hartley,202,U.S. Senate,,LIB,Rebecca Paddock,5,3,2,0
Hartley,301,U.S. Senate,,LIB,Rebecca Paddock,4,0,4,0
Hartley,401,U.S. Senate,,LIB,Rebecca Paddock,10,4,6,0
Hartley,101,U.S. Senate,,GRN,"Emily ""Spicybrown"" Sanchez",0,0,0,0
Hartley,102,U.S. Senate,,GRN,"Emily ""Spicybrown"" Sanchez",0,0,0,0
Hartley,201,U.S. Senate,,GRN,"Emily ""Spicybrown"" Sanchez",1,0,1,0
Hartley,202,U.S. Senate,,GRN,"Emily ""Spicybrown"" Sanchez",0,0,0,0
Hartley,301,U.S. Senate,,GRN,"Emily ""Spicybrown"" Sanchez",0,0,0,0
Hartley,401,U.S. Senate,,GRN,"Emily ""Spicybrown"" Sanchez",1,1,0,0
Hartley,101,U.S. Senate,,NON,WRITE-IN,0,0,0,0
Hartley,102,U.S. Senate,,NON,WRITE-IN,0,0,0,0
Hartley,201,U.S. Senate,,NON,WRITE-IN,0,0,0,0
Hartley,202,U.S. Senate,,NON,WRITE-IN,0,0,0,0
Hartley,301,U.S. Senate,,NON,WRITE-IN,0,0,0,0
Hartley,401,U.S. Senate,,NON,WRITE-IN,0,0,0,0
Hartley,101,U.S. Senate,,,OVER VOTES,0,0,0,0
Hartley,102,U.S. Senate,,,OVER VOTES,0,0,0,0
Hartley,201,U.S. Senate,,,OVER VOTES,0,0,0,0
Hartley,202,U.S. Senate,,,OVER VOTES,0,0,0,0
Hartley,301,U.S. Senate,,,OVER VOTES,0,0,0,0
Hartley,401,U.S. Senate,,,OVER VOTES,0,0,0,0
Hartley,101,U.S. Senate,,,UNDER VOTES,0,0,0,0
Hartley,102,U.S. Senate,,,UNDER VOTES,0,0,0,0
Hartley,201,U.S. Senate,,,UNDER VOTES,3,0,3,0
Hartley,202,U.S. Senate,,,UNDER VOTES,0,0,0,0
Hartley,301,U.S. Senate,,,UNDER VOTES,5,3,2,0
Hartley,401,U.S. Senate,,,UNDER VOTES,1,1,0,0
Hartley,101,U.S. House,13,REP,Mac Thornberry,123,27,96,0
Hartley,102,U.S. House,13,REP,Mac Thornberry,65,27,38,0
Hartley,201,U.S. House,13,REP,Mac Thornberry,92,31,61,0
Hartley,202,U.S. House,13,REP,Mac Thornberry,170,68,102,0
Hartley,301,U.S. House,13,REP,Mac Thornberry,310,130,180,0
Hartley,401,U.S. House,13,REP,Mac Thornberry,239,103,136,0
Hartley,101,U.S. House,13,DEM,Mike Minter,12,5,7,0
Hartley,102,U.S. House,13,DEM,Mike Minter,5,0,5,0
Hartley,201,U.S. House,13,DEM,Mike Minter,8,3,5,0
Hartley,202,U.S. House,13,DEM,Mike Minter,8,4,4,0
Hartley,301,U.S. House,13,DEM,Mike Minter,23,8,15,0
Hartley,401,U.S. House,13,DEM,Mike Minter,32,15,17,0
Hartley,101,U.S. House,13,LIB,Emily Pivoda,1,1,0,0
Hartley,102,U.S. House,13,LIB,Emily Pivoda,1,1,0,0
Hartley,201,U.S. House,13,LIB,Emily Pivoda,1,0,1,0
Hartley,202,U.S. House,13,LIB,Emily Pivoda,5,3,2,0
Hartley,301,U.S. House,13,LIB,Emily Pivoda,1,0,1,0
Hartley,401,U.S. House,13,LIB,Emily Pivoda,8,3,5,0
Hartley,101,U.S. House,13,GRN,Don Cook,1,1,0,0
Hartley,102,U.S. House,13,GRN,Don Cook,0,0,0,0
Hartley,201,U.S. House,13,GRN,Don Cook,1,0,1,0
Hartley,202,U.S. House,13,GRN,Don Cook,0,0,0,0
Hartley,301,U.S. House,13,GRN,Don Cook,1,0,1,0
Hartley,401,U.S. House,13,GRN,Don Cook,1,0,1,0
Hartley,101,U.S. House,13,,OVER VOTES,0,0,0,0
Hartley,102,U.S. House,13,,OVER VOTES,0,0,0,0
Hartley,201,U.S. House,13,,OVER VOTES,0,0,0,0
Hartley,202,U.S. House,13,,OVER VOTES,0,0,0,0
Hartley,301,U.S. House,13,,OVER VOTES,0,0,0,0
Hartley,401,U.S. House,13,,OVER VOTES,0,0,0,0
Hartley,101,U.S. House,13,,UNDER VOTES,0,0,0,0
Hartley,102,U.S. House,13,,UNDER VOTES,0,0,0,0
Hartley,201,U.S. House,13,,UNDER VOTES,2,0,2,0
Hartley,202,U.S. House,13,,UNDER VOTES,1,1,0,0
Hartley,301,U.S. House,13,,UNDER VOTES,2,1,1,0
Hartley,401,U.S. House,13,,UNDER VOTES,1,1,0,0
Hartley,101,Governor,,REP,Greg Abbott,123,28,95,0
Hartley,102,Governor,,REP,Greg Abbott,66,28,38,0
Hartley,201,Governor,,REP,Greg Abbott,92,31,61,0
Hartley,202,Governor,,REP,Greg Abbott,172,73,99,0
Hartley,301,Governor,,REP,Greg Abbott,309,130,179,0
Hartley,401,Governor,,REP,Greg Abbott,244,105,139,0
Hartley,101,Governor,,DEM,Wendy R. Davis,13,5,8,0
Hartley,102,Governor,,DEM,Wendy R. Davis,5,0,5,0
Hartley,201,Governor,,DEM,Wendy R. Davis,9,3,6,0
Hartley,202,Governor,,DEM,Wendy R. Davis,8,3,5,0
Hartley,301,Governor,,DEM,Wendy R. Davis,22,7,15,0
Hartley,401,Governor,,DEM,Wendy R. Davis,30,13,17,0
Hartley,101,Governor,,LIB,Kathie Glass,0,0,0,0
Hartley,102,Governor,,LIB,Kathie Glass,0,0,0,0
Hartley,201,Governor,,LIB,Kathie Glass,1,0,1,0
Hartley,202,Governor,,LIB,Kathie Glass,3,0,3,0
Hartley,301,Governor,,LIB,Kathie Glass,2,0,2,0
Hartley,401,Governor,,LIB,Kathie Glass,6,3,3,0
Hartley,101,Governor,,GRN,Brandon Parmer,1,1,0,0
Hartley,102,Governor,,GRN,Brandon Parmer,0,0,0,0
Hartley,201,Governor,,GRN,Brandon Parmer,0,0,0,0
Hartley,202,Governor,,GRN,Brandon Parmer,0,0,0,0
Hartley,301,Governor,,GRN,Brandon Parmer,1,0,1,0
Hartley,401,Governor,,GRN,Brandon Parmer,1,1,0,0
Hartley,101,Governor,,NON,WRITE-IN,0,0,0,0
Hartley,102,Governor,,NON,WRITE-IN,0,0,0,0
Hartley,201,Governor,,NON,WRITE-IN,0,0,0,0
Hartley,202,Governor,,NON,WRITE-IN,0,0,0,0
Hartley,301,Governor,,NON,WRITE-IN,0,0,0,0
Hartley,401,Governor,,NON,WRITE-IN,0,0,0,0
Hartley,101,Governor,,,OVER VOTES,0,0,0,0
Hartley,102,Governor,,,OVER VOTES,0,0,0,0
Hartley,201,Governor,,,OVER VOTES,0,0,0,0
Hartley,202,Governor,,,OVER VOTES,0,0,0,0
Hartley,301,Governor,,,OVER VOTES,0,0,0,0
Hartley,401,Governor,,,OVER VOTES,0,0,0,0
Hartley,101,Governor,,,UNDER VOTES,0,0,0,0
Hartley,102,Governor,,,UNDER VOTES,0,0,0,0
Hartley,201,Governor,,,UNDER VOTES,2,0,2,0
Hartley,202,Governor,,,UNDER VOTES,1,0,1,0
Hartley,301,Governor,,,UNDER VOTES,3,2,1,0
Hartley,401,Governor,,,UNDER VOTES,0,0,0,0
Hartley,101,Lieutenant Governor,,REP,Dan Patrick,126,29,97,0
Hartley,102,Lieutenant Governor,,REP,Dan Patrick,66,28,38,0
Hartley,201,Lieutenant Governor,,REP,Dan Patrick,89,30,59,0
Hartley,202,Lieutenant Governor,,REP,Dan Patrick,172,73,99,0
Hartley,301,Lieutenant Governor,,REP,Dan Patrick,305,126,179,0
Hartley,401,Lieutenant Governor,,REP,Dan Patrick,246,106,140,0
Hartley,101,Lieutenant Governor,,DEM,Leticia Van de Putte,9,4,5,0
Hartley,102,Lieutenant Governor,,DEM,Leticia Van de Putte,5,0,5,0
Hartley,201,Lieutenant Governor,,DEM,Leticia Van de Putte,11,4,7,0
Hartley,202,Lieutenant Governor,,DEM,Leticia Van de Putte,5,2,3,0
Hartley,301,Lieutenant Governor,,DEM,Leticia Van de Putte,23,9,14,0
Hartley,401,Lieutenant Governor,,DEM,Leticia Van de Putte,22,10,12,0
Hartley,101,Lieutenant Governor,,LIB,Robert D. Butler,2,1,1,0
Hartley,102,Lieutenant Governor,,LIB,Robert D. Butler,0,0,0,0
Hartley,201,Lieutenant Governor,,LIB,Robert D. Butler,1,0,1,0
Hartley,202,Lieutenant Governor,,LIB,Robert D. Butler,4,0,4,0
Hartley,301,Lieutenant Governor,,LIB,Robert D. Butler,5,2,3,0
Hartley,401,Lieutenant Governor,,LIB,Robert D. Butler,11,6,5,0
Hartley,101,Lieutenant Governor,,GRN,Chandrakantha Courtney,0,0,0,0
Hartley,102,Lieutenant Governor,,GRN,Chandrakantha Courtney,0,0,0,0
Hartley,201,Lieutenant Governor,,GRN,Chandrakantha Courtney,1,0,1,0
Hartley,202,Lieutenant Governor,,GRN,Chandrakantha Courtney,1,0,1,0
Hartley,301,Lieutenant Governor,,GRN,Chandrakantha Courtney,0,0,0,0
Hartley,401,Lieutenant Governor,,GRN,Chandrakantha Courtney,0,0,0,0
Hartley,101,Lieutenant Governor,,,OVER VOTES,0,0,0,0
Hartley,102,Lieutenant Governor,,,OVER VOTES,0,0,0,0
Hartley,201,Lieutenant Governor,,,OVER VOTES,0,0,0,0
Hartley,202,Lieutenant Governor,,,OVER VOTES,0,0,0,0
Hartley,301,Lieutenant Governor,,,OVER VOTES,0,0,0,0
Hartley,401,Lieutenant Governor,,,OVER VOTES,0,0,0,0
Hartley,101,Lieutenant Governor,,,UNDER VOTES,0,0,0,0
Hartley,102,Lieutenant Governor,,,UNDER VOTES,0,0,0,0
Hartley,201,Lieutenant Governor,,,UNDER VOTES,2,0,2,0
Hartley,202,Lieutenant Governor,,,UNDER VOTES,2,1,1,0
Hartley,301,Lieutenant Governor,,,UNDER VOTES,4,2,2,0
Hartley,401,Lieutenant Governor,,,UNDER VOTES,2,0,2,0
Hartley,101,Attorney General,,REP,Ken Paxton,120,27,93,0
Hartley,102,Attorney General,,REP,Ken Paxton,67,28,39,0
Hartley,201,Attorney General,,REP,Ken Paxton,93,33,60,0
Hartley,202,Attorney General,,REP,Ken Paxton,167,71,96,0
Hartley,301,Attorney General,,REP,Ken Paxton,310,130,180,0
Hartley,401,Attorney General,,REP,Ken Paxton,239,106,133,0
Hartley,101,Attorney General,,DEM,Sam Houston,15,6,9,0
Hartley,102,Attorney General,,DEM,Sam Houston,4,0,4,0
Hartley,201,Attorney General,,DEM,Sam Houston,7,1,6,0
Hartley,202,Attorney General,,DEM,Sam Houston,11,2,9,0
Hartley,301,Attorney General,,DEM,Sam Houston,23,7,16,0
Hartley,401,Attorney General,,DEM,Sam Houston,32,13,19,0
Hartley,101,Attorney General,,LIB,Jamie Balagia,2,1,1,0
Hartley,102,Attorney General,,LIB,Jamie Balagia,0,0,0,0
Hartley,201,Attorney General,,LIB,Jamie Balagia,0,0,0,0
Hartley,202,Attorney General,,LIB,Jamie Balagia,3,1,2,0
Hartley,301,Attorney General,,LIB,Jamie Balagia,0,0,0,0
Hartley,401,Attorney General,,LIB,Jamie Balagia,7,2,5,0
Hartley,101,Attorney General,,GRN,Jamar Osborne,0,0,0,0
Hartley,102,Attorney General,,GRN,Jamar Osborne,0,0,0,0
Hartley,201,Attorney General,,GRN,Jamar Osborne,1,0,1,0
Hartley,202,Attorney General,,GRN,Jamar Osborne,1,1,0,0
Hartley,301,Attorney General,,GRN,Jamar Osborne,0,0,0,0
Hartley,401,Attorney General,,GRN,Jamar Osborne,1,0,1,0
Hartley,101,Attorney General,,,OVER VOTES,0,0,0,0
Hartley,102,Attorney General,,,OVER VOTES,0,0,0,0
Hartley,201,Attorney General,,,OVER VOTES,0,0,0,0
Hartley,202,Attorney General,,,OVER VOTES,0,0,0,0
Hartley,301,Attorney General,,,OVER VOTES,0,0,0,0
Hartley,401,Attorney General,,,OVER VOTES,0,0,0,0
Hartley,101,Attorney General,,,UNDER VOTES,0,0,0,0
Hartley,102,Attorney General,,,UNDER VOTES,0,0,0,0
Hartley,201,Attorney General,,,UNDER VOTES,3,0,3,0
Hartley,202,Attorney General,,,UNDER VOTES,2,1,1,0
Hartley,301,Attorney General,,,UNDER VOTES,4,2,2,0
Hartley,401,Attorney General,,,UNDER VOTES,2,1,1,0
Hartley,101,Comptroller of Public Accounts,,REP,Glenn Hegar,119,27,92,0
Hartley,102,Comptroller of Public Accounts,,REP,Glenn Hegar,64,26,38,0
Hartley,201,Comptroller of Public Accounts,,REP,Glenn Hegar,91,32,59,0
Hartley,202,Comptroller of Public Accounts,,REP,Glenn Hegar,160,67,93,0
Hartley,301,Comptroller of Public Accounts,,REP,Glenn Hegar,295,124,171,0
Hartley,401,Comptroller of Public Accounts,,REP,Glenn Hegar,232,104,128,0
Hartley,101,Comptroller of Public Accounts,,DEM,Mike Collier,15,5,10,0
Hartley,102,Comptroller of Public Accounts,,DEM,Mike Collier,5,0,5,0
Hartley,201,Comptroller of Public Accounts,,DEM,Mike Collier,9,2,7,0
Hartley,202,Comptroller of Public Accounts,,DEM,Mike Collier,12,3,9,0
Hartley,301,Comptroller of Public Accounts,,DEM,Mike Collier,22,9,13,0
Hartley,401,Comptroller of Public Accounts,,DEM,Mike Collier,32,12,20,0
Hartley,101,Comptroller of Public Accounts,,LIB,Ben Sanders,2,1,1,0
Hartley,102,Comptroller of Public Accounts,,LIB,Ben Sanders,0,0,0,0
Hartley,201,Comptroller of Public Accounts,,LIB,Ben Sanders,0,0,0,0
Hartley,202,Comptroller of Public Accounts,,LIB,Ben Sanders,6,3,3,0
Hartley,301,Comptroller of Public Accounts,,LIB,Ben Sanders,6,1,5,0
Hartley,401,Comptroller of Public Accounts,,LIB,Ben Sanders,11,3,8,0
Hartley,101,Comptroller of Public Accounts,,GRN,Deb Shafto,1,1,0,0
Hartley,102,Comptroller of Public Accounts,,GRN,Deb Shafto,0,0,0,0
Hartley,201,Comptroller of Public Accounts,,GRN,Deb Shafto,1,0,1,0
Hartley,202,Comptroller of Public Accounts,,GRN,Deb Shafto,0,0,0,0
Hartley,301,Comptroller of Public Accounts,,GRN,Deb Shafto,2,0,2,0
Hartley,401,Comptroller of Public Accounts,,GRN,Deb Shafto,0,0,0,0
Hartley,101,Comptroller of Public Accounts,,,OVER VOTES,0,0,0,0
Hartley,102,Comptroller of Public Accounts,,,OVER VOTES,0,0,0,0
Hartley,201,Comptroller of Public Accounts,,,OVER VOTES,0,0,0,0
Hartley,202,Comptroller of Public Accounts,,,OVER VOTES,0,0,0,0
Hartley,301,Comptroller of Public Accounts,,,OVER VOTES,0,0,0,0
Hartley,401,Comptroller of Public Accounts,,,OVER VOTES,0,0,0,0
Hartley,101,Comptroller of Public Accounts,,,UNDER VOTES,0,0,0,0
Hartley,102,Comptroller of Public Accounts,,,UNDER VOTES,2,2,0,0
Hartley,201,Comptroller of Public Accounts,,,UNDER VOTES,3,0,3,0
Hartley,202,Comptroller of Public Accounts,,,UNDER VOTES,6,3,3,0
Hartley,301,Comptroller of Public Accounts,,,UNDER VOTES,12,5,7,0
Hartley,401,Comptroller of Public Accounts,,,UNDER VOTES,6,3,3,0
Hartley,101,Commissioner of the General Land Office,,REP,George P. Bush,120,26,94,0
Hartley,102,Commissioner of the General Land Office,,REP,George P. Bush,64,26,38,0
Hartley,201,Commissioner of the General Land Office,,REP,George P. Bush,89,30,59,0
Hartley,202,Commissioner of the General Land Office,,REP,George P. Bush,164,67,97,0
Hartley,301,Commissioner of the General Land Office,,REP,George P. Bush,304,127,177,0
Hartley,401,Commissioner of the General Land Office,,REP,George P. Bush,232,101,131,0
Hartley,101,Commissioner of the General Land Office,,DEM,John Cook,13,6,7,0
Hartley,102,Commissioner of the General Land Office,,DEM,John Cook,5,1,4,0
Hartley,201,Commissioner of the General Land Office,,DEM,John Cook,12,4,8,0
Hartley,202,Commissioner of the General Land Office,,DEM,John Cook,11,3,8,0
Hartley,301,Commissioner of the General Land Office,,DEM,John Cook,15,6,9,0
Hartley,401,Commissioner of the General Land Office,,DEM,John Cook,35,16,19,0
Hartley,101,Commissioner of the General Land Office,,LIB,Justin Knight,4,2,2,0
Hartley,102,Commissioner of the General Land Office,,LIB,Justin Knight,1,0,1,0
Hartley,201,Commissioner of the General Land Office,,LIB,Justin Knight,1,0,1,0
Hartley,202,Commissioner of the General Land Office,,LIB,Justin Knight,4,2,2,0
Hartley,301,Commissioner of the General Land Office,,LIB,Justin Knight,8,1,7,0
Hartley,401,Commissioner of the General Land Office,,LIB,Justin Knight,10,4,6,0
Hartley,101,Commissioner of the General Land Office,,GRN,Valerie Alessi,0,0,0,0
Hartley,102,Commissioner of the General Land Office,,GRN,Valerie Alessi,1,1,0,0
Hartley,201,Commissioner of the General Land Office,,GRN,Valerie Alessi,1,0,1,0
Hartley,202,Commissioner of the General Land Office,,GRN,Valerie Alessi,1,1,0,0
Hartley,301,Commissioner of the General Land Office,,GRN,Valerie Alessi,2,0,2,0
Hartley,401,Commissioner of the General Land Office,,GRN,Valerie Alessi,1,0,1,0
Hartley,101,Commissioner of the General Land Office,,,OVER VOTES,0,0,0,0
Hartley,102,Commissioner of the General Land Office,,,OVER VOTES,0,0,0,0
Hartley,201,Commissioner of the General Land Office,,,OVER VOTES,0,0,0,0
Hartley,202,Commissioner of the General Land Office,,,OVER VOTES,0,0,0,0
Hartley,301,Commissioner of the General Land Office,,,OVER VOTES,0,0,0,0
Hartley,401,Commissioner of the General Land Office,,,OVER VOTES,0,0,0,0
Hartley,101,Commissioner of the General Land Office,,,UNDER VOTES,0,0,0,0
Hartley,102,Commissioner of the General Land Office,,,UNDER VOTES,0,0,0,0
Hartley,201,Commissioner of the General Land Office,,,UNDER VOTES,1,0,1,0
Hartley,202,Commissioner of the General Land Office,,,UNDER VOTES,4,3,1,0
Hartley,301,Commissioner of the General Land Office,,,UNDER VOTES,8,5,3,0
Hartley,401,Commissioner of the General Land Office,,,UNDER VOTES,3,1,2,0
Hartley,101,Commissioner of Agriculture,,REP,Sid Miller,123,28,95,0
Hartley,102,Commissioner of Agriculture,,REP,Sid Miller,64,26,38,0
Hartley,201,Commissioner of Agriculture,,REP,Sid Miller,88,30,58,0
Hartley,202,Commissioner of Agriculture,,REP,Sid Miller,156,67,89,0
Hartley,301,Commissioner of Agriculture,,REP,Sid Miller,293,121,172,0
Hartley,401,Commissioner of Agriculture,,REP,Sid Miller,233,100,133,0
Hartley,101,Commissioner of Agriculture,,DEM,Jim Hogan,10,5,5,0
Hartley,102,Commissioner of Agriculture,,DEM,Jim Hogan,6,1,5,0
Hartley,201,Commissioner of Agriculture,,DEM,Jim Hogan,10,4,6,0
Hartley,202,Commissioner of Agriculture,,DEM,Jim Hogan,16,4,12,0
Hartley,301,Commissioner of Agriculture,,DEM,Jim Hogan,26,11,15,0
Hartley,401,Commissioner of Agriculture,,DEM,Jim Hogan,34,16,18,0
Hartley,101,Commissioner of Agriculture,,LIB,David (Rocky) Palmquist,2,1,1,0
Hartley,102,Commissioner of Agriculture,,LIB,David (Rocky) Palmquist,0,0,0,0
Hartley,201,Commissioner of Agriculture,,LIB,David (Rocky) Palmquist,3,0,3,0
Hartley,202,Commissioner of Agriculture,,LIB,David (Rocky) Palmquist,5,2,3,0
Hartley,301,Commissioner of Agriculture,,LIB,David (Rocky) Palmquist,6,2,4,0
Hartley,401,Commissioner of Agriculture,,LIB,David (Rocky) Palmquist,6,3,3,0
Hartley,101,Commissioner of Agriculture,,GRN,Kenneth Kendrick,1,0,1,0
Hartley,102,Commissioner of Agriculture,,GRN,Kenneth Kendrick,0,0,0,0
Hartley,201,Commissioner of Agriculture,,GRN,Kenneth Kendrick,1,0,1,0
Hartley,202,Commissioner of Agriculture,,GRN,Kenneth Kendrick,3,1,2,0
Hartley,301,Commissioner of Agriculture,,GRN,Kenneth Kendrick,1,0,1,0
Hartley,401,Commissioner of Agriculture,,GRN,Kenneth Kendrick,2,0,2,0
Hartley,101,Commissioner of Agriculture,,,OVER VOTES,0,0,0,0
Hartley,102,Commissioner of Agriculture,,,OVER VOTES,0,0,0,0
Hartley,201,Commissioner of Agriculture,,,OVER VOTES,0,0,0,0
Hartley,202,Commissioner of Agriculture,,,OVER VOTES,0,0,0,0
Hartley,301,Commissioner of Agriculture,,,OVER VOTES,0,0,0,0
Hartley,401,Commissioner of Agriculture,,,OVER VOTES,0,0,0,0
Hartley,101,Commissioner of Agriculture,,,UNDER VOTES,1,0,1,0
Hartley,102,Commissioner of Agriculture,,,UNDER VOTES,1,1,0,0
Hartley,201,Commissioner of Agriculture,,,UNDER VOTES,2,0,2,0
Hartley,202,Commissioner of Agriculture,,,UNDER VOTES,4,2,2,0
Hartley,301,Commissioner of Agriculture,,,UNDER VOTES,11,5,6,0
Hartley,401,Commissioner of Agriculture,,,UNDER VOTES,6,3,3,0
Hartley,101,Railroad Commissioner,,REP,Ryan Sitton,113,25,88,0
Hartley,102,Railroad Commissioner,,REP,Ryan Sitton,62,24,38,0
Hartley,201,Railroad Commissioner,,REP,Ryan Sitton,88,31,57,0
Hartley,202,Railroad Commissioner,,REP,Ryan Sitton,159,68,91,0
Hartley,301,Railroad Commissioner,,REP,Ryan Sitton,297,123,174,0
Hartley,401,Railroad Commissioner,,REP,Ryan Sitton,226,97,129,0
Hartley,101,Railroad Commissioner,,DEM,Steve Brown,14,6,8,0
Hartley,102,Railroad Commissioner,,DEM,Steve Brown,6,2,4,0
Hartley,201,Railroad Commissioner,,DEM,Steve Brown,9,3,6,0
Hartley,202,Railroad Commissioner,,DEM,Steve Brown,14,2,12,0
Hartley,301,Railroad Commissioner,,DEM,Steve Brown,19,7,12,0
Hartley,401,Railroad Commissioner,,DEM,Steve Brown,30,14,16,0
Hartley,101,Railroad Commissioner,,LIB,Mark A. Miller,4,3,1,0
Hartley,102,Railroad Commissioner,,LIB,Mark A. Miller,3,2,1,0
Hartley,201,Railroad Commissioner,,LIB,Mark A. Miller,3,0,3,0
Hartley,202,Railroad Commissioner,,LIB,Mark A. Miller,5,2,3,0
Hartley,301,Railroad Commissioner,,LIB,Mark A. Miller,9,4,5,0
Hartley,401,Railroad Commissioner,,LIB,Mark A. Miller,15,5,10,0
Hartley,101,Railroad Commissioner,,GRN,Martina Salinas,1,0,1,0
Hartley,102,Railroad Commissioner,,GRN,Martina Salinas,0,0,0,0
Hartley,201,Railroad Commissioner,,GRN,Martina Salinas,1,0,1,0
Hartley,202,Railroad Commissioner,,GRN,Martina Salinas,1,1,0,0
Hartley,301,Railroad Commissioner,,GRN,Martina Salinas,0,0,0,0
Hartley,401,Railroad Commissioner,,GRN,Martina Salinas,1,1,0,0
Hartley,101,Railroad Commissioner,,,OVER VOTES,1,0,1,0
Hartley,102,Railroad Commissioner,,,OVER VOTES,0,0,0,0
Hartley,201,Railroad Commissioner,,,OVER VOTES,0,0,0,0
Hartley,202,Railroad Commissioner,,,OVER VOTES,0,0,0,0
Hartley,301,Railroad Commissioner,,,OVER VOTES,0,0,0,0
Hartley,401,Railroad Commissioner,,,OVER VOTES,0,0,0,0
Hartley,101,Railroad Commissioner,,,UNDER VOTES,4,0,4,0
Hartley,102,Railroad Commissioner,,,UNDER VOTES,0,0,0,0
Hartley,201,Railroad Commissioner,,,UNDER VOTES,3,0,3,0
Hartley,202,Railroad Commissioner,,,UNDER VOTES,5,3,2,0
Hartley,301,Railroad Commissioner,,,UNDER VOTES,12,5,7,0
Hartley,401,Railroad Commissioner,,,UNDER VOTES,9,5,4,0
Hartley,101,"Chief Justice, Supreme Court",,REP,Nathan Hecht,116,27,89,0
Hartley,102,"Chief Justice, Supreme Court",,REP,Nathan Hecht,63,26,37,0
Hartley,201,"Chief Justice, Supreme Court",,REP,Nathan Hecht,91,32,59,0
Hartley,202,"Chief Justice, Supreme Court",,REP,Nathan Hecht,162,65,97,0
Hartley,301,"Chief Justice, Supreme Court",,REP,Nathan Hecht,297,124,173,0
Hartley,401,"Chief Justice, Supreme Court",,REP,Nathan Hecht,233,101,132,0
Hartley,101,"Chief Justice, Supreme Court",,DEM,William Moody,12,4,8,0
Hartley,102,"Chief Justice, Supreme Court",,DEM,William Moody,5,0,5,0
Hartley,201,"Chief Justice, Supreme Court",,DEM,William Moody,8,2,6,0
Hartley,202,"Chief Justice, Supreme Court",,DEM,William Moody,10,4,6,0
Hartley,301,"Chief Justice, Supreme Court",,DEM,William Moody,22,6,16,0
Hartley,401,"Chief Justice, Supreme Court",,DEM,William Moody,28,13,15,0
Hartley,101,"Chief Justice, Supreme Court",,LIB,Tom Oxford,4,2,2,0
Hartley,102,"Chief Justice, Supreme Court",,LIB,Tom Oxford,2,1,1,0
Hartley,201,"Chief Justice, Supreme Court",,LIB,Tom Oxford,3,0,3,0
Hartley,202,"Chief Justice, Supreme Court",,LIB,Tom Oxford,4,2,2,0
Hartley,301,"Chief Justice, Supreme Court",,LIB,Tom Oxford,6,2,4,0
Hartley,401,"Chief Justice, Supreme Court",,LIB,Tom Oxford,12,4,8,0
Hartley,101,"Chief Justice, Supreme Court",,,OVER VOTES,0,0,0,0
Hartley,102,"Chief Justice, Supreme Court",,,OVER VOTES,0,0,0,0
Hartley,201,"Chief Justice, Supreme Court",,,OVER VOTES,0,0,0,0
Hartley,202,"Chief Justice, Supreme Court",,,OVER VOTES,0,0,0,0
Hartley,301,"Chief Justice, Supreme Court",,,OVER VOTES,0,0,0,0
Hartley,401,"Chief Justice, Supreme Court",,,OVER VOTES,0,0,0,0
Hartley,101,"Chief Justice, Supreme Court",,,UNDER VOTES,5,1,4,0
Hartley,102,"Chief Justice, Supreme Court",,,UNDER VOTES,1,1,0,0
Hartley,201,"Chief Justice, Supreme Court",,,UNDER VOTES,2,0,2,0
Hartley,202,"Chief Justice, Supreme Court",,,UNDER VOTES,8,5,3,0
Hartley,301,"Chief Justice, Supreme Court",,,UNDER VOTES,12,7,5,0
Hartley,401,"Chief Justice, Supreme Court",,,UNDER VOTES,8,4,4,0
Hartley,101,"Justice, Supreme Court, Place 6",,REP,Jeff Brown,119,28,91,0
Hartley,102,"Justice, Supreme Court, Place 6",,REP,Jeff Brown,62,27,35,0
Hartley,201,"Justice, Supreme Court, Place 6",,REP,Jeff Brown,91,32,59,0
Hartley,202,"Justice, Supreme Court, Place 6",,REP,Jeff Brown,161,67,94,0
Hartley,301,"Justice, Supreme Court, Place 6",,REP,Jeff Brown,304,126,178,0
Hartley,401,"Justice, Supreme Court, Place 6",,REP,Jeff Brown,235,101,134,0
Hartley,101,"Justice, Supreme Court, Place 6",,DEM,Lawrence Edward Meyers,12,4,8,0
Hartley,102,"Justice, Supreme Court, Place 6",,DEM,Lawrence Edward Meyers,5,0,5,0
Hartley,201,"Justice, Supreme Court, Place 6",,DEM,Lawrence Edward Meyers,8,2,6,0
Hartley,202,"Justice, Supreme Court, Place 6",,DEM,Lawrence Edward Meyers,9,2,7,0
Hartley,301,"Justice, Supreme Court, Place 6",,DEM,Lawrence Edward Meyers,14,5,9,0
Hartley,401,"Justice, Supreme Court, Place 6",,DEM,Lawrence Edward Meyers,28,14,14,0
Hartley,101,"Justice, Supreme Court, Place 6",,LIB,Mark Ash,2,1,1,0
Hartley,102,"Justice, Supreme Court, Place 6",,LIB,Mark Ash,3,0,3,0
Hartley,201,"Justice, Supreme Court, Place 6",,LIB,Mark Ash,2,0,2,0
Hartley,202,"Justice, Supreme Court, Place 6",,LIB,Mark Ash,6,2,4,0
Hartley,301,"Justice, Supreme Court, Place 6",,LIB,Mark Ash,6,1,5,0
Hartley,401,"Justice, Supreme Court, Place 6",,LIB,Mark Ash,9,2,7,0
Hartley,101,"Justice, Supreme Court, Place 6",,,OVER VOTES,0,0,0,0
Hartley,102,"Justice, Supreme Court, Place 6",,,OVER VOTES,0,0,0,0
Hartley,201,"Justice, Supreme Court, Place 6",,,OVER VOTES,0,0,0,0
Hartley,202,"Justice, Supreme Court, Place 6",,,OVER VOTES,0,0,0,0
Hartley,301,"Justice, Supreme Court, Place 6",,,OVER VOTES,0,0,0,0
Hartley,401,"Justice, Supreme Court, Place 6",,,OVER VOTES,0,0,0,0
Hartley,101,"Justice, Supreme Court, Place 6",,,UNDER VOTES,4,1,3,0
Hartley,102,"Justice, Supreme Court, Place 6",,,UNDER VOTES,1,1,0,0
Hartley,201,"Justice, Supreme Court, Place 6",,,UNDER VOTES,3,0,3,0
Hartley,202,"Justice, Supreme Court, Place 6",,,UNDER VOTES,8,5,3,0
Hartley,301,"Justice, Supreme Court, Place 6",,,UNDER VOTES,13,7,6,0
Hartley,401,"Justice, Supreme Court, Place 6",,,UNDER VOTES,9,5,4,0
Hartley,101,"Justice, Supreme Court, Place 7",,REP,Jeff Boyd,118,28,90,0
Hartley,102,"Justice, Supreme Court, Place 7",,REP,Jeff Boyd,63,26,37,0
Hartley,201,"Justice, Supreme Court, Place 7",,REP,Jeff Boyd,91,30,61,0
Hartley,202,"Justice, Supreme Court, Place 7",,REP,Jeff Boyd,161,65,96,0
Hartley,301,"Justice, Supreme Court, Place 7",,REP,Jeff Boyd,299,124,175,0
Hartley,401,"Justice, Supreme Court, Place 7",,REP,Jeff Boyd,229,101,128,0
Hartley,101,"Justice, Supreme Court, Place 7",,DEM,Gina Benavides,10,3,7,0
Hartley,102,"Justice, Supreme Court, Place 7",,DEM,Gina Benavides,5,0,5,0
Hartley,201,"Justice, Supreme Court, Place 7",,DEM,Gina Benavides,8,3,5,0
Hartley,202,"Justice, Supreme Court, Place 7",,DEM,Gina Benavides,9,3,6,0
Hartley,301,"Justice, Supreme Court, Place 7",,DEM,Gina Benavides,15,5,10,0
Hartley,401,"Justice, Supreme Court, Place 7",,DEM,Gina Benavides,32,13,19,0
Hartley,101,"Justice, Supreme Court, Place 7",,LIB,Don Fulton,5,2,3,0
Hartley,102,"Justice, Supreme Court, Place 7",,LIB,Don Fulton,2,1,1,0
Hartley,201,"Justice, Supreme Court, Place 7",,LIB,Don Fulton,2,1,1,0
Hartley,202,"Justice, Supreme Court, Place 7",,LIB,Don Fulton,5,2,3,0
Hartley,301,"Justice, Supreme Court, Place 7",,LIB,Don Fulton,7,2,5,0
Hartley,401,"Justice, Supreme Court, Place 7",,LIB,Don Fulton,10,2,8,0
Hartley,101,"Justice, Supreme Court, Place 7",,GRN,Charles E. Waterbury,0,0,0,0
Hartley,102,"Justice, Supreme Court, Place 7",,GRN,Charles E. Waterbury,0,0,0,0
Hartley,201,"Justice, Supreme Court, Place 7",,GRN,Charles E. Waterbury,0,0,0,0
Hartley,202,"Justice, Supreme Court, Place 7",,GRN,Charles E. Waterbury,1,1,0,0
Hartley,301,"Justice, Supreme Court, Place 7",,GRN,Charles E. Waterbury,3,1,2,0
Hartley,401,"Justice, Supreme Court, Place 7",,GRN,Charles E. Waterbury,0,0,0,0
Hartley,101,"Justice, Supreme Court, Place 7",,,OVER VOTES,0,0,0,0
Hartley,102,"Justice, Supreme Court, Place 7",,,OVER VOTES,0,0,0,0
Hartley,201,"Justice, Supreme Court, Place 7",,,OVER VOTES,0,0,0,0
Hartley,202,"Justice, Supreme Court, Place 7",,,OVER VOTES,0,0,0,0
Hartley,301,"Justice, Supreme Court, Place 7",,,OVER VOTES,0,0,0,0
Hartley,401,"Justice, Supreme Court, Place 7",,,OVER VOTES,0,0,0,0
Hartley,101,"Justice, Supreme Court, Place 7",,,UNDER VOTES,4,1,3,0
Hartley,102,"Justice, Supreme Court, Place 7",,,UNDER VOTES,1,1,0,0
Hartley,201,"Justice, Supreme Court, Place 7",,,UNDER VOTES,3,0,3,0
Hartley,202,"Justice, Supreme Court, Place 7",,,UNDER VOTES,8,5,3,0
Hartley,301,"Justice, Supreme Court, Place 7",,,UNDER VOTES,13,7,6,0
Hartley,401,"Justice, Supreme Court, Place 7",,,UNDER VOTES,10,6,4,0
Hartley,101,"Justice, Supreme Court, Place 8",,REP,Phil Johnson,122,28,94,0
Hartley,102,"Justice, Supreme Court, Place 8",,REP,Phil Johnson,64,27,37,0
Hartley,201,"Justice, Supreme Court, Place 8",,REP,Phil Johnson,95,32,63,0
Hartley,202,"Justice, Supreme Court, Place 8",,REP,Phil Johnson,164,66,98,0
Hartley,301,"Justice, Supreme Court, Place 8",,REP,Phil Johnson,300,123,177,0
Hartley,401,"Justice, Supreme Court, Place 8",,REP,Phil Johnson,234,99,135,0
Hartley,101,"Justice, Supreme Court, Place 8",,LIB,RS Roberto Koelsch,2,1,1,0
Hartley,102,"Justice, Supreme Court, Place 8",,LIB,RS Roberto Koelsch,3,0,3,0
Hartley,201,"Justice, Supreme Court, Place 8",,LIB,RS Roberto Koelsch,0,0,0,0
Hartley,202,"Justice, Supreme Court, Place 8",,LIB,RS Roberto Koelsch,5,1,4,0
Hartley,301,"Justice, Supreme Court, Place 8",,LIB,RS Roberto Koelsch,8,2,6,0
Hartley,401,"Justice, Supreme Court, Place 8",,LIB,RS Roberto Koelsch,13,5,8,0
Hartley,101,"Justice, Supreme Court, Place 8",,GRN,Jim Chisolm,3,2,1,0
Hartley,102,"Justice, Supreme Court, Place 8",,GRN,Jim Chisolm,2,0,2,0
Hartley,201,"Justice, Supreme Court, Place 8",,GRN,Jim Chisolm,3,1,2,0
Hartley,202,"Justice, Supreme Court, Place 8",,GRN,Jim Chisolm,5,2,3,0
Hartley,301,"Justice, Supreme Court, Place 8",,GRN,Jim Chisolm,7,2,5,0
Hartley,401,"Justice, Supreme Court, Place 8",,GRN,Jim Chisolm,13,8,5,0
Hartley,101,"Justice, Supreme Court, Place 8",,,OVER VOTES,0,0,0,0
Hartley,102,"Justice, Supreme Court, Place 8",,,OVER VOTES,0,0,0,0
Hartley,201,"Justice, Supreme Court, Place 8",,,OVER VOTES,0,0,0,0
Hartley,202,"Justice, Supreme Court, Place 8",,,OVER VOTES,0,0,0,0
Hartley,301,"Justice, Supreme Court, Place 8",,,OVER VOTES,0,0,0,0
Hartley,401,"Justice, Supreme Court, Place 8",,,OVER VOTES,0,0,0,0
Hartley,101,"Justice, Supreme Court, Place 8",,,UNDER VOTES,10,3,7,0
Hartley,102,"Justice, Supreme Court, Place 8",,,UNDER VOTES,2,1,1,0
Hartley,201,"Justice, Supreme Court, Place 8",,,UNDER VOTES,6,1,5,0
Hartley,202,"Justice, Supreme Court, Place 8",,,UNDER VOTES,10,7,3,0
Hartley,301,"Justice, Supreme Court, Place 8",,,UNDER VOTES,22,12,10,0
Hartley,401,"Justice, Supreme Court, Place 8",,,UNDER VOTES,21,10,11,0
Hartley,101,"Judge, Court of Criminal Appeals, Pl 3",,REP,Bert Richardson,115,28,87,0
Hartley,102,"Judge, Court of Criminal Appeals, Pl 3",,REP,Bert Richardson,62,26,36,0
Hartley,201,"Judge, Court of Criminal Appeals, Pl 3",,REP,Bert Richardson,90,31,59,0
Hartley,202,"Judge, Court of Criminal Appeals, Pl 3",,REP,Bert Richardson,158,65,93,0
Hartley,301,"Judge, Court of Criminal Appeals, Pl 3",,REP,Bert Richardson,295,123,172,0
Hartley,401,"Judge, Court of Criminal Appeals, Pl 3",,REP,Bert Richardson,226,99,127,0
Hartley,101,"Judge, Court of Criminal Appeals, Pl 3",,DEM,John Granberg,12,3,9,0
Hartley,102,"Judge, Court of Criminal Appeals, Pl 3",,DEM,John Granberg,5,0,5,0
Hartley,201,"Judge, Court of Criminal Appeals, Pl 3",,DEM,John Granberg,10,3,7,0
Hartley,202,"Judge, Court of Criminal Appeals, Pl 3",,DEM,John Granberg,10,2,8,0
Hartley,301,"Judge, Court of Criminal Appeals, Pl 3",,DEM,John Granberg,20,8,12,0
Hartley,401,"Judge, Court of Criminal Appeals, Pl 3",,DEM,John Granberg,29,12,17,0
Hartley,101,"Judge, Court of Criminal Appeals, Pl 3",,LIB,Mark W. Bennett,3,1,2,0
Hartley,102,"Judge, Court of Criminal Appeals, Pl 3",,LIB,Mark W. Bennett,2,1,1,0
Hartley,201,"Judge, Court of Criminal Appeals, Pl 3",,LIB,Mark W. Bennett,1,0,1,0
Hartley,202,"Judge, Court of Criminal Appeals, Pl 3",,LIB,Mark W. Bennett,6,3,3,0
Hartley,301,"Judge, Court of Criminal Appeals, Pl 3",,LIB,Mark W. Bennett,8,1,7,0
Hartley,401,"Judge, Court of Criminal Appeals, Pl 3",,LIB,Mark W. Bennett,13,3,10,0
Hartley,101,"Judge, Court of Criminal Appeals, Pl 3",,,OVER VOTES,0,0,0,0
Hartley,102,"Judge, Court of Criminal Appeals, Pl 3",,,OVER VOTES,0,0,0,0
Hartley,201,"Judge, Court of Criminal Appeals, Pl 3",,,OVER VOTES,0,0,0,0
Hartley,202,"Judge, Court of Criminal Appeals, Pl 3",,,OVER VOTES,0,0,0,0
Hartley,301,"Judge, Court of Criminal Appeals, Pl 3",,,OVER VOTES,0,0,0,0
Hartley,401,"Judge, Court of Criminal Appeals, Pl 3",,,OVER VOTES,0,0,0,0
Hartley,101,"Judge, Court of Criminal Appeals, Pl 3",,,UNDER VOTES,7,2,5,0
Hartley,102,"Judge, Court of Criminal Appeals, Pl 3",,,UNDER VOTES,2,1,1,0
Hartley,201,"Judge, Court of Criminal Appeals, Pl 3",,,UNDER VOTES,3,0,3,0
Hartley,202,"Judge, Court of Criminal Appeals, Pl 3",,,UNDER VOTES,10,6,4,0
Hartley,301,"Judge, Court of Criminal Appeals, Pl 3",,,UNDER VOTES,14,7,7,0
Hartley,401,"Judge, Court of Criminal Appeals, Pl 3",,,UNDER VOTES,13,8,5,0
Hartley,101,"Judge, Court of Criminal Appeals, Pl 4",,REP,Kevin Patrick Yeary,115,26,89,0
Hartley,102,"Judge, Court of Criminal Appeals, Pl 4",,REP,Kevin Patrick Yeary,61,26,35,0
Hartley,201,"Judge, Court of Criminal Appeals, Pl 4",,REP,Kevin Patrick Yeary,91,29,62,0
Hartley,202,"Judge, Court of Criminal Appeals, Pl 4",,REP,Kevin Patrick Yeary,157,63,94,0
Hartley,301,"Judge, Court of Criminal Appeals, Pl 4",,REP,Kevin Patrick Yeary,296,124,172,0
Hartley,401,"Judge, Court of Criminal Appeals, Pl 4",,REP,Kevin Patrick Yeary,230,97,133,0
Hartley,101,"Judge, Court of Criminal Appeals, Pl 4",,LIB,Quanah Parker,10,4,6,0
Hartley,102,"Judge, Court of Criminal Appeals, Pl 4",,LIB,Quanah Parker,6,1,5,0
Hartley,201,"Judge, Court of Criminal Appeals, Pl 4",,LIB,Quanah Parker,5,4,1,0
Hartley,202,"Judge, Court of Criminal Appeals, Pl 4",,LIB,Quanah Parker,13,5,8,0
Hartley,301,"Judge, Court of Criminal Appeals, Pl 4",,LIB,Quanah Parker,19,4,15,0
Hartley,401,"Judge, Court of Criminal Appeals, Pl 4",,LIB,Quanah Parker,24,11,13,0
Hartley,101,"Judge, Court of Criminal Appeals, Pl 4",,GRN,Judith Sanders-Castro,0,0,0,0
Hartley,102,"Judge, Court of Criminal Appeals, Pl 4",,GRN,Judith Sanders-Castro,1,0,1,0
Hartley,201,"Judge, Court of Criminal Appeals, Pl 4",,GRN,Judith Sanders-Castro,2,0,2,0
Hartley,202,"Judge, Court of Criminal Appeals, Pl 4",,GRN,Judith Sanders-Castro,3,1,2,0
Hartley,301,"Judge, Court of Criminal Appeals, Pl 4",,GRN,Judith Sanders-Castro,2,0,2,0
Hartley,401,"Judge, Court of Criminal Appeals, Pl 4",,GRN,Judith Sanders-Castro,8,5,3,0
Hartley,101,"Judge, Court of Criminal Appeals, Pl 4",,,OVER VOTES,0,0,0,0
Hartley,102,"Judge, Court of Criminal Appeals, Pl 4",,,OVER VOTES,0,0,0,0
Hartley,201,"Judge, Court of Criminal Appeals, Pl 4",,,OVER VOTES,0,0,0,0
Hartley,202,"Judge, Court of Criminal Appeals, Pl 4",,,OVER VOTES,0,0,0,0
Hartley,301,"Judge, Court of Criminal Appeals, Pl 4",,,OVER VOTES,0,0,0,0
Hartley,401,"Judge, Court of Criminal Appeals, Pl 4",,,OVER VOTES,0,0,0,0
Hartley,101,"Judge, Court of Criminal Appeals, Pl 4",,,UNDER VOTES,12,4,8,0
Hartley,102,"Judge, Court of Criminal Appeals, Pl 4",,,UNDER VOTES,3,1,2,0
Hartley,201,"Judge, Court of Criminal Appeals, Pl 4",,,UNDER VOTES,6,1,5,0
Hartley,202,"Judge, Court of Criminal Appeals, Pl 4",,,UNDER VOTES,11,7,4,0
Hartley,301,"Judge, Court of Criminal Appeals, Pl 4",,,UNDER VOTES,20,11,9,0
Hartley,401,"Judge, Court of Criminal Appeals, Pl 4",,,UNDER VOTES,19,9,10,0
Hartley,101,"Judge, Court of Criminal Appeals, Pl 9",,REP,David Newell,120,29,91,0
Hartley,102,"Judge, Court of Criminal Appeals, Pl 9",,REP,David Newell,61,25,36,0
Hartley,201,"Judge, Court of Criminal Appeals, Pl 9",,REP,David Newell,95,33,62,0
Hartley,202,"Judge, Court of Criminal Appeals, Pl 9",,REP,David Newell,164,65,99,0
Hartley,301,"Judge, Court of Criminal Appeals, Pl 9",,REP,David Newell,302,127,175,0
Hartley,401,"Judge, Court of Criminal Appeals, Pl 9",,REP,David Newell,236,100,136,0
Hartley,101,"Judge, Court of Criminal Appeals, Pl 9",,LIB,"William Bryan Strange, III",5,1,4,0
Hartley,102,"Judge, Court of Criminal Appeals, Pl 9",,LIB,"William Bryan Strange, III",5,1,4,0
Hartley,201,"Judge, Court of Criminal Appeals, Pl 9",,LIB,"William Bryan Strange, III",2,1,1,0
Hartley,202,"Judge, Court of Criminal Appeals, Pl 9",,LIB,"William Bryan Strange, III",7,4,3,0
Hartley,301,"Judge, Court of Criminal Appeals, Pl 9",,LIB,"William Bryan Strange, III",11,1,10,0
Hartley,401,"Judge, Court of Criminal Appeals, Pl 9",,LIB,"William Bryan Strange, III",20,10,10,0
Hartley,101,"Judge, Court of Criminal Appeals, Pl 9",,GRN,George Joseph Altgelt,0,0,0,0
Hartley,102,"Judge, Court of Criminal Appeals, Pl 9",,GRN,George Joseph Altgelt,2,1,1,0
Hartley,201,"Judge, Court of Criminal Appeals, Pl 9",,GRN,George Joseph Altgelt,2,0,2,0
Hartley,202,"Judge, Court of Criminal Appeals, Pl 9",,GRN,George Joseph Altgelt,2,0,2,0
Hartley,301,"Judge, Court of Criminal Appeals, Pl 9",,GRN,George Joseph Altgelt,2,0,2,0
Hartley,401,"Judge, Court of Criminal Appeals, Pl 9",,GRN,George Joseph Altgelt,4,2,2,0
Hartley,101,"Judge, Court of Criminal Appeals, Pl 9",,,OVER VOTES,0,0,0,0
Hartley,102,"Judge, Court of Criminal Appeals, Pl 9",,,OVER VOTES,0,0,0,0
Hartley,201,"Judge, Court of Criminal Appeals, Pl 9",,,OVER VOTES,0,0,0,0
Hartley,202,"Judge, Court of Criminal Appeals, Pl 9",,,OVER VOTES,0,0,0,0
Hartley,301,"Judge, Court of Criminal Appeals, Pl 9",,,OVER VOTES,0,0,0,0
Hartley,401,"Judge, Court of Criminal Appeals, Pl 9",,,OVER VOTES,0,0,0,0
Hartley,101,"Judge, Court of Criminal Appeals, Pl 9",,,UNDER VOTES,12,4,8,0
Hartley,102,"Judge, Court of Criminal Appeals, Pl 9",,,UNDER VOTES,3,1,2,0
Hartley,201,"Judge, Court of Criminal Appeals, Pl 9",,,UNDER VOTES,5,0,5,0
Hartley,202,"Judge, Court of Criminal Appeals, Pl 9",,,UNDER VOTES,11,7,4,0
Hartley,301,"Judge, Court of Criminal Appeals, Pl 9",,,UNDER VOTES,22,11,11,0
Hartley,401,"Judge, Court of Criminal Appeals, Pl 9",,,UNDER VOTES,21,10,11,0
Hartley,101,State Senator,31,REP,Kel Seliger,123,29,94,0
Hartley,102,State Senator,31,REP,Kel Seliger,64,23,41,0
Hartley,201,State Senator,31,REP,Kel Seliger,90,30,60,0
Hartley,202,State Senator,31,REP,Kel Seliger,169,71,98,0
Hartley,301,State Senator,31,REP,Kel Seliger,304,127,177,0
Hartley,401,State Senator,31,REP,Kel Seliger,231,101,130,0
Hartley,101,State Senator,31,LIB,Steven Gibson,7,2,5,0
Hartley,102,State Senator,31,LIB,Steven Gibson,5,4,1,0
Hartley,201,State Senator,31,LIB,Steven Gibson,10,4,6,0
Hartley,202,State Senator,31,LIB,Steven Gibson,13,3,10,0
Hartley,301,State Senator,31,LIB,Steven Gibson,21,6,15,0
Hartley,401,State Senator,31,LIB,Steven Gibson,35,13,22,0
Hartley,101,State Senator,31,,OVER VOTES,0,0,0,0
Hartley,102,State Senator,31,,OVER VOTES,0,0,0,0
Hartley,201,State Senator,31,,OVER VOTES,0,0,0,0
Hartley,202,State Senator,31,,OVER VOTES,0,0,0,0
Hartley,301,State Senator,31,,OVER VOTES,0,0,0,0
Hartley,401,State Senator,31,,OVER VOTES,0,0,0,0
Hartley,101,State Senator,31,,UNDER VOTES,7,3,4,0
Hartley,102,State Senator,31,,UNDER VOTES,2,1,1,0
Hartley,201,State Senator,31,,UNDER VOTES,4,0,4,0
Hartley,202,State Senator,31,,UNDER VOTES,2,2,0,0
Hartley,301,State Senator,31,,UNDER VOTES,12,6,6,0
Hartley,401,State Senator,31,,UNDER VOTES,15,8,7,0
Hartley,101,State Representative,86,REP,John Smithee,126,31,95,0
Hartley,102,State Representative,86,REP,John Smithee,67,27,40,0
Hartley,201,State Representative,86,REP,John Smithee,97,33,64,0
Hartley,202,State Representative,86,REP,John Smithee,161,64,97,0
Hartley,301,State Representative,86,REP,John Smithee,313,129,184,0
Hartley,401,State Representative,86,REP,John Smithee,246,104,142,0
Hartley,101,State Representative,86,,OVER VOTES,0,0,0,0
Hartley,102,State Representative,86,,OVER VOTES,0,0,0,0
Hartley,201,State Representative,86,,OVER VOTES,0,0,0,0
Hartley,202,State Representative,86,,OVER VOTES,0,0,0,0
Hartley,301,State Representative,86,,OVER VOTES,0,0,0,0
Hartley,401,State Representative,86,,OVER VOTES,0,0,0,0
Hartley,101,State Representative,86,,UNDER VOTES,11,3,8,0
Hartley,102,State Representative,86,,UNDER VOTES,4,1,3,0
Hartley,201,State Representative,86,,UNDER VOTES,7,1,6,0
Hartley,202,State Representative,86,,UNDER VOTES,23,12,11,0
Hartley,301,State Representative,86,,UNDER VOTES,24,10,14,0
Hartley,401,State Representative,86,,UNDER VOTES,35,18,17,0
Hartley,101,"Chief Justice, 7th CT of Appeals DIST",,REP,Brian Quinn,122,28,94,0
Hartley,102,"Chief Justice, 7th CT of Appeals DIST",,REP,Brian Quinn,65,25,40,0
Hartley,201,"Chief Justice, 7th CT of Appeals DIST",,REP,Brian Quinn,97,33,64,0
Hartley,202,"Chief Justice, 7th CT of Appeals DIST",,REP,Brian Quinn,163,63,100,0
Hartley,301,"Chief Justice, 7th CT of Appeals DIST",,REP,Brian Quinn,305,126,179,0
Hartley,401,"Chief Justice, 7th CT of Appeals DIST",,REP,Brian Quinn,251,108,143,0
Hartley,101,"Chief Justice, 7th CT of Appeals DIST",,,OVER VOTES,0,0,0,0
Hartley,102,"Chief Justice, 7th CT of Appeals DIST",,,OVER VOTES,0,0,0,0
Hartley,201,"Chief Justice, 7th CT of Appeals DIST",,,OVER VOTES,0,0,0,0
Hartley,202,"Chief Justice, 7th CT of Appeals DIST",,,OVER VOTES,0,0,0,0
Hartley,301,"Chief Justice, 7th CT of Appeals DIST",,,OVER VOTES,0,0,0,0
Hartley,401,"Chief Justice, 7th CT of Appeals DIST",,,OVER VOTES,0,0,0,0
Hartley,101,"Chief Justice, 7th CT of Appeals DIST",,,UNDER VOTES,15,6,9,0
Hartley,102,"Chief Justice, 7th CT of Appeals DIST",,,UNDER VOTES,6,3,3,0
Hartley,201,"Chief Justice, 7th CT of Appeals DIST",,,UNDER VOTES,7,1,6,0
Hartley,202,"Chief Justice, 7th CT of Appeals DIST",,,UNDER VOTES,21,13,8,0
Hartley,301,"Chief Justice, 7th CT of Appeals DIST",,,UNDER VOTES,32,13,19,0
Hartley,401,"Chief Justice, 7th CT of Appeals DIST",,,UNDER VOTES,30,14,16,0
Hartley,101,"District Judge, 69th Judicial District",,REP,Ron Enns,126,31,95,0
Hartley,102,"District Judge, 69th Judicial District",,REP,Ron Enns,68,26,42,0
Hartley,201,"District Judge, 69th Judicial District",,REP,Ron Enns,97,33,64,0
Hartley,202,"District Judge, 69th Judicial District",,REP,Ron Enns,168,68,100,0
Hartley,301,"District Judge, 69th Judicial District",,REP,Ron Enns,314,124,190,0
Hartley,401,"District Judge, 69th Judicial District",,REP,Ron Enns,246,106,140,0
Hartley,101,"District Judge, 69th Judicial District",,,OVER VOTES,0,0,0,0
Hartley,102,"District Judge, 69th Judicial District",,,OVER VOTES,0,0,0,0
Hartley,201,"District Judge, 69th Judicial District",,,OVER VOTES,0,0,0,0
Hartley,202,"District Judge, 69th Judicial District",,,OVER VOTES,0,0,0,0
Hartley,301,"District Judge, 69th Judicial District",,,OVER VOTES,0,0,0,0
Hartley,401,"District Judge, 69th Judicial District",,,OVER VOTES,0,0,0,0
Hartley,101,"District Judge, 69th Judicial District",,,UNDER VOTES,11,3,8,0
Hartley,102,"District Judge, 69th Judicial District",,,UNDER VOTES,3,2,1,0
Hartley,201,"District Judge, 69th Judicial District",,,UNDER VOTES,7,1,6,0
Hartley,202,"District Judge, 69th Judicial District",,,UNDER VOTES,16,8,8,0
Hartley,301,"District Judge, 69th Judicial District",,,UNDER VOTES,23,15,8,0
Hartley,401,"District Judge, 69th Judicial District",,,UNDER VOTES,35,16,19,0
Hartley,101,County Judge,,REP,Ronnie Gordon,125,30,95,0
Hartley,102,County Judge,,REP,Ronnie Gordon,67,25,42,0
Hartley,201,County Judge,,REP,Ronnie Gordon,100,33,67,0
Hartley,202,County Judge,,REP,Ronnie Gordon,169,68,101,0
Hartley,301,County Judge,,REP,Ronnie Gordon,316,126,190,0
Hartley,401,County Judge,,REP,Ronnie Gordon,253,111,142,0
Hartley,101,County Judge,,,OVER VOTES,0,0,0,0
Hartley,102,County Judge,,,OVER VOTES,0,0,0,0
Hartley,201,County Judge,,,OVER VOTES,0,0,0,0
Hartley,202,County Judge,,,OVER VOTES,0,0,0,0
Hartley,301,County Judge,,,OVER VOTES,0,0,0,0
Hartley,401,County Judge,,,OVER VOTES,0,0,0,0
Hartley,101,County Judge,,,UNDER VOTES,12,4,8,0
Hartley,102,County Judge,,,UNDER VOTES,4,3,1,0
Hartley,201,County Judge,,,UNDER VOTES,4,1,3,0
Hartley,202,County Judge,,,UNDER VOTES,15,8,7,0
Hartley,301,County Judge,,,UNDER VOTES,21,13,8,0
Hartley,401,County Judge,,,UNDER VOTES,28,11,17,0
Hartley,101,District and County Clerk,,REP,Melissa Mead,128,31,97,0
Hartley,102,District and County Clerk,,REP,Melissa Mead,65,25,40,0
Hartley,201,District and County Clerk,,REP,Melissa Mead,96,34,62,0
Hartley,202,District and County Clerk,,REP,Melissa Mead,167,66,101,0
Hartley,301,District and County Clerk,,REP,Melissa Mead,309,125,184,0
Hartley,401,District and County Clerk,,REP,Melissa Mead,254,110,144,0
Hartley,101,District and County Clerk,,,OVER VOTES,0,0,0,0
Hartley,102,District and County Clerk,,,OVER VOTES,0,0,0,0
Hartley,201,District and County Clerk,,,OVER VOTES,0,0,0,0
Hartley,202,District and County Clerk,,,OVER VOTES,0,0,0,0
Hartley,301,District and County Clerk,,,OVER VOTES,0,0,0,0
Hartley,401,District and County Clerk,,,OVER VOTES,0,0,0,0
Hartley,101,District and County Clerk,,,UNDER VOTES,9,3,6,0
Hartley,102,District and County Clerk,,,UNDER VOTES,6,3,3,0
Hartley,201,District and County Clerk,,,UNDER VOTES,8,0,8,0
Hartley,202,District and County Clerk,,,UNDER VOTES,17,10,7,0
Hartley,301,District and County Clerk,,,UNDER VOTES,28,14,14,0
Hartley,401,District and County Clerk,,,UNDER VOTES,27,12,15,0
Hartley,101,County Treasurer,,REP,Dinkie Parman,129,32,97,0
Hartley,102,County Treasurer,,REP,Dinkie Parman,66,25,41,0
Hartley,201,County Treasurer,,REP,Dinkie Parman,97,33,64,0
Hartley,202,County Treasurer,,REP,Dinkie Parman,168,67,101,0
Hartley,301,County Treasurer,,REP,Dinkie Parman,311,126,185,0
Hartley,401,County Treasurer,,REP,Dinkie Parman,250,108,142,0
Hartley,101,County Treasurer,,,OVER VOTES,0,0,0,0
Hartley,102,County Treasurer,,,OVER VOTES,0,0,0,0
Hartley,201,County Treasurer,,,OVER VOTES,0,0,0,0
Hartley,202,County Treasurer,,,OVER VOTES,0,0,0,0
Hartley,301,County Treasurer,,,OVER VOTES,0,0,0,0
Hartley,401,County Treasurer,,,OVER VOTES,0,0,0,0
Hartley,101,County Treasurer,,,UNDER VOTES,8,2,6,0
Hartley,102,County Treasurer,,,UNDER VOTES,5,3,2,0
Hartley,201,County Treasurer,,,UNDER VOTES,7,1,6,0
Hartley,202,County Treasurer,,,UNDER VOTES,16,9,7,0
Hartley,301,County Treasurer,,,UNDER VOTES,26,13,13,0
Hartley,401,County Treasurer,,,UNDER VOTES,31,14,17,0
Hartley,201,"County Commissioner, Precinct No. 2",,REP,David Ford,97,33,64,0
Hartley,202,"County Commissioner, Precinct No. 2",,REP,David Ford,166,66,100,0
Hartley,201,"County Commissioner, Precinct No. 2",,,OVER VOTES,0,0,0,0
Hartley,202,"County Commissioner, Precinct No. 2",,,OVER VOTES,0,0,0,0
Hartley,201,"County Commissioner, Precinct No. 2",,,UNDER VOTES,7,1,6,0
Hartley,202,"County Commissioner, Precinct No. 2",,,UNDER VOTES,18,10,8,0
Hartley,401,"County Commissioner, Precinct No. 4",,REP,"Robert ""Butch"" Owens",248,106,142,0
Hartley,401,"County Commissioner, Precinct No. 4",,,OVER VOTES,0,0,0,0
Hartley,401,"County Commissioner, Precinct No. 4",,,UNDER VOTES,33,16,17,0
Hartley,101,"Justice of the Peace, Countywide",,REP,Beth Bezner Moore,126,32,94,0
Hartley,102,"Justice of the Peace, Countywide",,REP,Beth Bezner Moore,67,27,40,0
Hartley,201,"Justice of the Peace, Countywide",,REP,Beth Bezner Moore,99,34,65,0
Hartley,202,"Justice of the Peace, Countywide",,REP,Beth Bezner Moore,165,64,101,0
Hartley,301,"Justice of the Peace, Countywide",,REP,Beth Bezner Moore,314,130,184,0
Hartley,401,"Justice of the Peace, Countywide",,REP,Beth Bezner Moore,252,110,142,0
Hartley,101,"Justice of the Peace, Countywide",,,OVER VOTES,0,0,0,0
Hartley,102,"Justice of the Peace, Countywide",,,OVER VOTES,0,0,0,0
Hartley,201,"Justice of the Peace, Countywide",,,OVER VOTES,0,0,0,0
Hartley,202,"Justice of the Peace, Countywide",,,OVER VOTES,0,0,0,0
Hartley,301,"Justice of the Peace, Countywide",,,OVER VOTES,0,0,0,0
Hartley,401,"Justice of the Peace, Countywide",,,OVER VOTES,0,0,0,0
Hartley,101,"Justice of the Peace, Countywide",,,UNDER VOTES,11,2,9,0
Hartley,102,"Justice of the Peace, Countywide",,,UNDER VOTES,4,1,3,0
Hartley,201,"Justice of the Peace, Countywide",,,UNDER VOTES,5,0,5,0
Hartley,202,"Justice of the Peace, Countywide",,,UNDER VOTES,19,12,7,0
Hartley,301,"Justice of the Peace, Countywide",,,UNDER VOTES,23,9,14,0
Hartley,401,"Justice of the Peace, Countywide",,,UNDER VOTES,29,12,17,0
Hartley,101,Proposed Constitutional Amendment,,NON,For,79,21,58,0
Hartley,102,Proposed Constitutional Amendment,,NON,For,41,20,21,0
Hartley,201,Proposed Constitutional Amendment,,NON,For,61,24,37,0
Hartley,202,Proposed Constitutional Amendment,,NON,For,114,41,73,0
Hartley,301,Proposed Constitutional Amendment,,NON,For,232,91,141,0
Hartley,401,Proposed Constitutional Amendment,,NON,For,183,82,101,0
Hartley,101,Proposed Constitutional Amendment,,NON,Against,14,5,9,0
Hartley,102,Proposed Constitutional Amendment,,NON,Against,6,1,5,0
Hartley,201,Proposed Constitutional Amendment,,NON,Against,18,6,12,0
Hartley,202,Proposed Constitutional Amendment,,NON,Against,22,11,11,0
Hartley,301,Proposed Constitutional Amendment,,NON,Against,39,18,21,0
Hartley,401,Proposed Constitutional Amendment,,NON,Against,35,11,24,0
Hartley,101,Proposed Constitutional Amendment,,,OVER VOTES,0,0,0,0
Hartley,102,Proposed Constitutional Amendment,,,OVER VOTES,0,0,0,0
Hartley,201,Proposed Constitutional Amendment,,,OVER VOTES,0,0,0,0
Hartley,202,Proposed Constitutional Amendment,,,OVER VOTES,0,0,0,0
Hartley,301,Proposed Constitutional Amendment,,,OVER VOTES,0,0,0,0
Hartley,401,Proposed Constitutional Amendment,,,OVER VOTES,0,0,0,0
Hartley,101,Proposed Constitutional Amendment,,,UNDER VOTES,44,8,36,0
Hartley,102,Proposed Constitutional Amendment,,,UNDER VOTES,24,7,17,0
Hartley,201,Proposed Constitutional Amendment,,,UNDER VOTES,25,4,21,0
Hartley,202,Proposed Constitutional Amendment,,,UNDER VOTES,48,24,24,0
Hartley,301,Proposed Constitutional Amendment,,,UNDER VOTES,66,30,36,0
Hartley,401,Proposed Constitutional Amendment,,,UNDER VOTES,63,29,34,0