county,precinct,office,district,party,candidate,election_day,absentee,early_voting,votes
DeWitt,101,President,,Democratic Party,Amy Klobuchar,0,1,0,1
DeWitt,101,President,,Democratic Party,Joseph R. Biden,21,6,3,30
DeWitt,101,President,,Democratic Party,Michael Bennet,0,0,0,0
DeWitt,101,President,,Democratic Party,Marianne Williamson,0,0,0,0
DeWitt,101,President,,Democratic Party,Michael R. Bloomberg,1,1,5,7
DeWitt,101,President,,Democratic Party,Elizabeth Warren,4,0,3,7
DeWitt,101,President,,Democratic Party,Andrew Yang,1,0,0,1
DeWitt,101,President,,Democratic Party,Tom Steyer,0,0,0,0
DeWitt,101,President,,Democratic Party,Pete Buttigieg,1,0,1,2
DeWitt,101,President,,Democratic Party,Tulsi Gabbard,0,0,0,0
DeWitt,101,President,,Democratic Party,Robby Wells,0,0,0,0
DeWitt,101,President,,Democratic Party,Deval Patrick,0,0,0,0
DeWitt,101,President,,Democratic Party,Bernie Sanders,6,2,8,16
DeWitt,101,President,,Democratic Party,"Roque ""Rocky"" De La Fuente Guerra",0,0,0,0
DeWitt,101,President,,Democratic Party,John K. Delaney,0,0,0,0
DeWitt,101,President,,Democratic Party,Cory Booker,0,0,0,0
DeWitt,101,President,,Democratic Party,Juli√°n Castro,0,2,0,2
DeWitt,101,Ballots Cast,,Democratic Party,,34,12,20,66
DeWitt,101,President,,Democratic Party,Undervotes,0,0,0,0
DeWitt,101,President,,Democratic Party,Overvotes,0,0,0,0
DeWitt,101,United States Senator,,Democratic Party,Victor Hugo Harris,1,0,0,1
DeWitt,101,United States Senator,,Democratic Party,"Annie ""Mam√°"" Garcia",10,0,2,12
DeWitt,101,United States Senator,,Democratic Party,Amanda K. Edwards,2,0,4,6
DeWitt,101,United States Senator,,Democratic Party,Royce West,1,0,0,1
DeWitt,101,United States Senator,,Democratic Party,Adrian Ocegueda,2,0,1,3
DeWitt,101,United States Senator,,Democratic Party,D.R. Hunter,1,0,0,1
DeWitt,101,United States Senator,,Democratic Party,Michael Cooper,3,1,0,4
DeWitt,101,United States Senator,,Democratic Party,Chris Bell,2,0,6,8
DeWitt,101,United States Senator,,Democratic Party,Cristina Tzintzun Ramirez,2,3,0,5
DeWitt,101,United States Senator,,Democratic Party,Sema Hernandez,2,0,1,3
DeWitt,101,United States Senator,,Democratic Party,Jack Daniel Foster Jr,0,0,0,0
DeWitt,101,United States Senator,,Democratic Party,"Mary ""MJ"" Hegar",1,4,3,8
DeWitt,101,Ballots Cast,,Democratic Party,,27,8,17,52
DeWitt,101,United States Senator,,Democratic Party,Undervotes,7,3,3,13
DeWitt,101,United States Senator,,Democratic Party,Overvotes,0,1,0,1
DeWitt,101,"United States Representative, District No. 34",,Democratic Party,Diego Zavala,11,1,4,16
DeWitt,101,"United States Representative, District No. 34",,Democratic Party,Osbert Haro,2,1,0,3
DeWitt,101,"United States Representative, District No. 34",,Democratic Party,Filemon B. Vela,16,8,13,37
DeWitt,101,Ballots Cast,,Democratic Party,,29,10,17,56
DeWitt,101,"United States Representative, District No. 34",,Democratic Party,Undervotes,5,2,3,10
DeWitt,101,"United States Representative, District No. 34",,Democratic Party,Overvotes,0,0,0,0
DeWitt,101,Railroad Commissioner,,Democratic Party,Chrysta Casta√±eda,8,6,4,18
DeWitt,101,Railroad Commissioner,,Democratic Party,Kelly Stone,6,0,6,12
DeWitt,101,Railroad Commissioner,,Democratic Party,Mark Watson,3,2,7,12
DeWitt,101,Railroad Commissioner,,Democratic Party,"Roberto R. ""Beto"" Alonzo",14,2,0,16
DeWitt,101,Ballots Cast,,Democratic Party,,31,10,17,58
DeWitt,101,Railroad Commissioner,,Democratic Party,Undervotes,3,2,3,8
DeWitt,101,Railroad Commissioner,,Democratic Party,Overvotes,0,0,0,0
DeWitt,101,"Chief Justice, Supreme Court",,Democratic Party,Jerry Zimmerer,7,3,4,14
DeWitt,101,"Chief Justice, Supreme Court",,Democratic Party,Amy Clark Meachum,22,5,13,40
DeWitt,101,Ballots Cast,,Democratic Party,,29,8,17,54
DeWitt,101,"Chief Justice, Supreme Court",,Democratic Party,Undervotes,5,4,3,12
DeWitt,101,"Chief Justice, Supreme Court",,Democratic Party,Overvotes,0,0,0,0
DeWitt,101,"Justice, Supreme Court, Place 6 Unexpired Term",,Democratic Party,Larry Praeger,8,1,6,15
DeWitt,101,"Justice, Supreme Court, Place 6 Unexpired Term",,Democratic Party,Kathy Cheng,21,7,11,39
DeWitt,101,Ballots Cast,,Democratic Party,,29,8,17,54
DeWitt,101,"Justice, Supreme Court, Place 6 Unexpired Term",,Democratic Party,Undervotes,5,4,3,12
DeWitt,101,"Justice, Supreme Court, Place 6 Unexpired Term",,Democratic Party,Overvotes,0,0,0,0
DeWitt,101,"Justice, Supreme Court, Place 7",,Democratic Party,Staci Williams,17,4,11,32
DeWitt,101,"Justice, Supreme Court, Place 7",,Democratic Party,Brandy Voss,12,4,5,21
DeWitt,101,Ballots Cast,,Democratic Party,,29,8,16,53
DeWitt,101,"Justice, Supreme Court, Place 7",,Democratic Party,Undervotes,5,4,4,13
DeWitt,101,"Justice, Supreme Court, Place 7",,Democratic Party,Overvotes,0,0,0,0
DeWitt,101,"Justice, Supreme Court, Place 8",,Democratic Party,Peter Kelly,10,3,9,22
DeWitt,101,"Justice, Supreme Court, Place 8",,Democratic Party,Gisela D. Triana,20,7,8,35
DeWitt,101,Ballots Cast,,Democratic Party,,30,10,17,57
DeWitt,101,"Justice, Supreme Court, Place 8",,Democratic Party,Undervotes,4,2,3,9
DeWitt,101,"Justice, Supreme Court, Place 8",,Democratic Party,Overvotes,0,0,0,0
DeWitt,101,"Judge, Court of Criminal Appeals, Place 3",,Democratic Party,Dan Wood,7,4,5,16
DeWitt,101,"Judge, Court of Criminal Appeals, Place 3",,Democratic Party,William Pieratt Demond,1,0,3,4
DeWitt,101,"Judge, Court of Criminal Appeals, Place 3",,Democratic Party,Elizabeth Davis Frizell,20,5,9,34
DeWitt,101,Ballots Cast,,Democratic Party,,28,9,17,54
DeWitt,101,"Judge, Court of Criminal Appeals, Place 3",,Democratic Party,Undervotes,6,3,3,12
DeWitt,101,"Judge, Court of Criminal Appeals, Place 3",,Democratic Party,Overvotes,0,0,0,0
DeWitt,101,"Judge, Court of Criminal Appeals, Place 4",,Democratic Party,Steven Miears,5,1,4,10
DeWitt,101,"Judge, Court of Criminal Appeals, Place 4",,Democratic Party,Tina Clinton,25,7,12,44
DeWitt,101,Ballots Cast,,Democratic Party,,30,8,16,54
DeWitt,101,"Judge, Court of Criminal Appeals, Place 4",,Democratic Party,Undervotes,4,4,4,12
DeWitt,101,"Judge, Court of Criminal Appeals, Place 4",,Democratic Party,Overvotes,0,0,0,0
DeWitt,101,"Judge, Court of Criminal Appeals, Place 9",,Democratic Party,Brandon Birmingham,27,7,16,50
DeWitt,101,Ballots Cast,,Democratic Party,,27,7,16,50
DeWitt,101,"Judge, Court of Criminal Appeals, Place 9",,Democratic Party,Undervotes,7,5,4,16
DeWitt,101,"Judge, Court of Criminal Appeals, Place 9",,Democratic Party,Overvotes,0,0,0,0
DeWitt,101,"State Senator, District 18",,Democratic Party,Michael Antalan,27,5,15,47
DeWitt,101,Ballots Cast,,Democratic Party,,27,5,15,47
DeWitt,101,"State Senator, District 18",,Democratic Party,Undervotes,7,7,5,19
DeWitt,101,"State Senator, District 18",,Democratic Party,Overvotes,0,0,0,0
DeWitt,101,County Chairman,,Democratic Party,Jospeh L. Sheppard,26,10,18,54
DeWitt,101,Ballots Cast,,Democratic Party,,26,10,18,54
DeWitt,101,County Chairman,,Democratic Party,Undervotes,8,2,2,12
DeWitt,101,County Chairman,,Democratic Party,Overvotes,0,0,0,0
DeWitt,101,President,,Republican Party,Zoltan G. Istvan,0,0,0,0
DeWitt,101,President,,Republican Party,Donald J. Trump,156,35,200,391
DeWitt,101,President,,Republican Party,Bill Weld,1,1,3,5
DeWitt,101,President,,Republican Party,Joe Walsh,2,0,0,2
DeWitt,101,President,,Republican Party,"Roque ""Rocky"" De La Fuente Guerra",1,0,1,2
DeWitt,101,President,,Republican Party,Matthew John Matern,0,0,0,0
DeWitt,101,President,,Republican Party,Bob Ely,0,0,2,2
DeWitt,101,President,,Republican Party,Uncommitted,6,1,2,9
DeWitt,101,Ballots Cast,,Republican Party,,166,37,208,411
DeWitt,101,President,,Republican Party,Undervotes,1,0,2,3
DeWitt,101,President,,Republican Party,Overvotes,0,0,0,0
DeWitt,101,United States Senator,,Republican Party,Dwayne Stovall,40,6,44,90
DeWitt,101,United States Senator,,Republican Party,Mark Yancey,7,1,8,16
DeWitt,101,United States Senator,,Republican Party,Virgil Bierschwale,6,0,1,7
DeWitt,101,United States Senator,,Republican Party,John Cornyn,94,28,138,260
DeWitt,101,United States Senator,,Republican Party,John Anthony Castro,7,1,7,15
DeWitt,101,Ballots Cast,,Republican Party,,154,36,198,388
DeWitt,101,United States Senator,,Republican Party,Undervotes,13,1,12,26
DeWitt,101,United States Senator,,Republican Party,Overvotes,0,0,0,0
DeWitt,101,"United States Representative, District No. 34",,Republican Party,Rey Gonzalez,89,17,119,225
DeWitt,101,"United States Representative, District No. 34",,Republican Party,Rod Lingsch,59,12,65,136
DeWitt,101,Ballots Cast,,Republican Party,,148,29,184,361
DeWitt,101,"United States Representative, District No. 34",,Republican Party,Undervotes,19,8,26,53
DeWitt,101,"United States Representative, District No. 34",,Republican Party,Overvotes,0,0,0,0
DeWitt,101,Railroad Commissioner,,Republican Party,Ryan Sitton,53,9,67,129
DeWitt,101,Railroad Commissioner,,Republican Party,"James ""Jim"" Wright",88,20,120,228
DeWitt,101,Ballots Cast,,Republican Party,,141,29,187,357
DeWitt,101,Railroad Commissioner,,Republican Party,Undervotes,26,8,23,57
DeWitt,101,Railroad Commissioner,,Republican Party,Overvotes,0,0,0,0
DeWitt,101,"Chief Justice, Supreme Court",,Republican Party,Nathan Hecht,144,27,175,346
DeWitt,101,Ballots Cast,,Republican Party,,144,27,175,346
DeWitt,101,"Chief Justice, Supreme Court",,Republican Party,Undervotes,23,10,35,68
DeWitt,101,"Chief Justice, Supreme Court",,Republican Party,Overvotes,0,0,0,0
DeWitt,101,"Justice, Supreme Court, Place 6 Unexpired Term",,Republican Party,Jane Bland,145,27,169,341
DeWitt,101,Ballots Cast,,Republican Party,,145,27,169,341
DeWitt,101,"Justice, Supreme Court, Place 6 Unexpired Term",,Republican Party,Undervotes,22,10,41,73
DeWitt,101,"Justice, Supreme Court, Place 6 Unexpired Term",,Republican Party,Overvotes,0,0,0,0
DeWitt,101,"Justice, Supreme Court, Place 7",,Republican Party,Jeff Boyd,148,27,171,346
DeWitt,101,Ballots Cast,,Republican Party,,148,27,171,346
DeWitt,101,"Justice, Supreme Court, Place 7",,Republican Party,Undervotes,19,10,39,68
DeWitt,101,"Justice, Supreme Court, Place 7",,Republican Party,Overvotes,0,0,0,0
DeWitt,101,"Justice, Supreme Court, Place 8",,Republican Party,Brett Busby,146,27,169,342
DeWitt,101,Ballots Cast,,Republican Party,,146,27,169,342
DeWitt,101,"Justice, Supreme Court, Place 8",,Republican Party,Undervotes,21,10,41,72
DeWitt,101,"Justice, Supreme Court, Place 8",,Republican Party,Overvotes,0,0,0,0
DeWitt,101,"Judge, Court of Criminal Appeals, Place 3",,Republican Party,Gina Parker,80,13,111,204
DeWitt,101,"Judge, Court of Criminal Appeals, Place 3",,Republican Party,Bert Richardson,62,17,65,144
DeWitt,101,Ballots Cast,,Republican Party,,142,30,176,348
DeWitt,101,"Judge, Court of Criminal Appeals, Place 3",,Republican Party,Undervotes,25,6,34,65
DeWitt,101,"Judge, Court of Criminal Appeals, Place 3",,Republican Party,Overvotes,0,1,0,1
DeWitt,101,"Judge, Court of Criminal Appeals, Place 4",,Republican Party,Kevin Patrick Yeary,145,27,167,339
DeWitt,101,Ballots Cast,,Republican Party,,145,27,167,339
DeWitt,101,"Judge, Court of Criminal Appeals, Place 4",,Republican Party,Undervotes,22,10,43,75
DeWitt,101,"Judge, Court of Criminal Appeals, Place 4",,Republican Party,Overvotes,0,0,0,0
DeWitt,101,"Judge, Court of Criminal Appeals, Place 9",,Republican Party,David Newell,143,27,167,337
DeWitt,101,Ballots Cast,,Republican Party,,143,27,167,337
DeWitt,101,"Judge, Court of Criminal Appeals, Place 9",,Republican Party,Undervotes,24,10,43,77
DeWitt,101,"Judge, Court of Criminal Appeals, Place 9",,Republican Party,Overvotes,0,0,0,0
DeWitt,101,"State Senator, District 18",,Republican Party,Lois W. Kolkhorst,158,31,181,370
DeWitt,101,Ballots Cast,,Republican Party,,158,31,181,370
DeWitt,101,"State Senator, District 18",,Republican Party,Undervotes,9,6,29,44
DeWitt,101,"State Senator, District 18",,Republican Party,Overvotes,0,0,0,0
DeWitt,101,"State Representative, District 30",,Republican Party,Geanie W. Morrison,135,34,179,348
DeWitt,101,"State Representative, District 30",,Republican Party,Vanessa Hicks-Callaway,25,2,25,52
DeWitt,101,Ballots Cast,,Republican Party,,160,36,204,400
DeWitt,101,"State Representative, District 30",,Republican Party,Undervotes,7,1,6,14
DeWitt,101,"State Representative, District 30",,Republican Party,Overvotes,0,0,0,0
DeWitt,101,"District Attorney, 24th Judicial District",,Republican Party,"Robert C. ""Rob"" Lassman",155,32,178,365
DeWitt,101,Ballots Cast,,Republican Party,,155,32,178,365
DeWitt,101,"District Attorney, 24th Judicial District",,Republican Party,Undervotes,12,5,32,49
DeWitt,101,"District Attorney, 24th Judicial District",,Republican Party,Overvotes,0,0,0,0
DeWitt,101,County Attorney,,Republican Party,Jay Condie,152,32,185,369
DeWitt,101,Ballots Cast,,Republican Party,,152,32,185,369
DeWitt,101,County Attorney,,Republican Party,Undervotes,15,5,25,45
DeWitt,101,County Attorney,,Republican Party,Overvotes,0,0,0,0
DeWitt,101,Sheriff,,Republican Party,Carl R. Bowen,154,31,188,373
DeWitt,101,Ballots Cast,,Republican Party,,154,31,188,373
DeWitt,101,Sheriff,,Republican Party,Undervotes,13,6,22,41
DeWitt,101,Sheriff,,Republican Party,Overvotes,0,0,0,0
DeWitt,101,County Tax Assessor-Collector,,Republican Party,Ashley D. Mraz,141,33,183,357
DeWitt,101,County Tax Assessor-Collector,,Republican Party,Guy Dolan,21,2,25,48
DeWitt,101,Ballots Cast,,Republican Party,,162,35,208,405
DeWitt,101,County Tax Assessor-Collector,,Republican Party,Undervotes,5,2,2,9
DeWitt,101,County Tax Assessor-Collector,,Republican Party,Overvotes,0,0,0,0
DeWitt,101,"County Commissioner, Precinct 1",,Republican Party,Curtis G. Afflerbach,155,31,184,370
DeWitt,101,Ballots Cast,,Republican Party,,155,31,184,370
DeWitt,101,"County Commissioner, Precinct 1",,Republican Party,Undervotes,12,6,26,44
DeWitt,101,"County Commissioner, Precinct 1",,Republican Party,Overvotes,0,0,0,0
DeWitt,101,"Constable, Precinct 1",,Republican Party,Kelly J. Phelps,149,29,176,354
DeWitt,101,Ballots Cast,,Republican Party,,149,29,176,354
DeWitt,101,"Constable, Precinct 1",,Republican Party,Undervotes,18,8,34,60
DeWitt,101,"Constable, Precinct 1",,Republican Party,Overvotes,0,0,0,0
DeWitt,101,County Chairman,,Republican Party,Paul Guidry,149,30,179,358
DeWitt,101,Ballots Cast,,Republican Party,,149,30,179,358
DeWitt,101,County Chairman,,Republican Party,Undervotes,18,7,31,56
DeWitt,101,County Chairman,,Republican Party,Overvotes,0,0,0,0
DeWitt,101,Proposition #1,,Democratic Party,Yes,29,9,16,54
DeWitt,101,Proposition #1,,Democratic Party,No,3,3,3,9
DeWitt,101,Ballots Cast,,Democratic Party,,32,12,19,63
DeWitt,101,Proposition #1,,Democratic Party,Undervotes,2,0,1,3
DeWitt,101,Proposition #1,,Democratic Party,Overvotes,0,0,0,0
DeWitt,101,Proposition #2,,Democratic Party,Yes,28,12,17,57
DeWitt,101,Proposition #2,,Democratic Party,No,2,0,2,4
DeWitt,101,Ballots Cast,,Democratic Party,,30,12,19,61
DeWitt,101,Proposition #2,,Democratic Party,Undervotes,4,0,1,5
DeWitt,101,Proposition #2,,Democratic Party,Overvotes,0,0,0,0
DeWitt,101,Proposition #3,,Democratic Party,Yes,26,12,19,57
DeWitt,101,Proposition #3,,Democratic Party,No,3,0,0,3
DeWitt,101,Ballots Cast,,Democratic Party,,29,12,19,60
DeWitt,101,Proposition #3,,Democratic Party,Undervotes,5,0,1,6
DeWitt,101,Proposition #3,,Democratic Party,Overvotes,0,0,0,0
DeWitt,101,Proposition #4,,Democratic Party,Yes,27,11,16,54
DeWitt,101,Proposition #4,,Democratic Party,No,5,1,3,9
DeWitt,101,Ballots Cast,,Democratic Party,,32,12,19,63
DeWitt,101,Proposition #4,,Democratic Party,Undervotes,2,0,1,3
DeWitt,101,Proposition #4,,Democratic Party,Overvotes,0,0,0,0
DeWitt,101,Proposition #5,,Democratic Party,Yes,29,12,19,60
DeWitt,101,Proposition #5,,Democratic Party,No,2,0,0,2
DeWitt,101,Ballots Cast,,Democratic Party,,31,12,19,62
DeWitt,101,Proposition #5,,Democratic Party,Undervotes,3,0,1,4
DeWitt,101,Proposition #5,,Democratic Party,Overvotes,0,0,0,0
DeWitt,101,Proposition #6,,Democratic Party,Yes,30,11,19,60
DeWitt,101,Proposition #6,,Democratic Party,No,2,1,0,3
DeWitt,101,Ballots Cast,,Democratic Party,,32,12,19,63
DeWitt,101,Proposition #6,,Democratic Party,Undervotes,2,0,1,3
DeWitt,101,Proposition #6,,Democratic Party,Overvotes,0,0,0,0
DeWitt,101,Proposition #7,,Democratic Party,Yes,27,11,18,56
DeWitt,101,Proposition #7,,Democratic Party,No,4,1,0,5
DeWitt,101,Ballots Cast,,Democratic Party,,31,12,18,61
DeWitt,101,Proposition #7,,Democratic Party,Undervotes,3,0,2,5
DeWitt,101,Proposition #7,,Democratic Party,Overvotes,0,0,0,0
DeWitt,101,Proposition #8,,Democratic Party,Yes,27,12,17,56
DeWitt,101,Proposition #8,,Democratic Party,No,2,0,2,4
DeWitt,101,Ballots Cast,,Democratic Party,,29,12,19,60
DeWitt,101,Proposition #8,,Democratic Party,Undervotes,5,0,1,6
DeWitt,101,Proposition #8,,Democratic Party,Overvotes,0,0,0,0
DeWitt,101,Proposition #9,,Democratic Party,Yes,26,12,17,55
DeWitt,101,Proposition #9,,Democratic Party,No,4,0,2,6
DeWitt,101,Ballots Cast,,Democratic Party,,30,12,19,61
DeWitt,101,Proposition #9,,Democratic Party,Undervotes,4,0,1,5
DeWitt,101,Proposition #9,,Democratic Party,Overvotes,0,0,0,0
DeWitt,101,Proposition #10,,Democratic Party,Yes,27,12,19,58
DeWitt,101,Proposition #10,,Democratic Party,No,4,0,0,4
DeWitt,101,Ballots Cast,,Democratic Party,,31,12,19,62
DeWitt,101,Proposition #10,,Democratic Party,Undervotes,3,0,1,4
DeWitt,101,Proposition #10,,Democratic Party,Overvotes,0,0,0,0
DeWitt,101,Proposition #11,,Democratic Party,Yes,25,10,18,53
DeWitt,101,Proposition #11,,Democratic Party,No,4,2,0,6
DeWitt,101,Ballots Cast,,Democratic Party,,29,12,18,59
DeWitt,101,Proposition #11,,Democratic Party,Undervotes,5,0,2,7
DeWitt,101,Proposition #11,,Democratic Party,Overvotes,0,0,0,0
DeWitt,101,Proposition 1,,Republican Party,Yes,134,33,180,347
DeWitt,101,Proposition 1,,Republican Party,No,29,4,23,56
DeWitt,101,Ballots Cast,,Republican Party,,163,37,203,403
DeWitt,101,Proposition 1,,Republican Party,Undervotes,4,0,7,11
DeWitt,101,Proposition 1,,Republican Party,Overvotes,0,0,0,0
DeWitt,101,Proposition 2,,Republican Party,Yes,135,33,174,342
DeWitt,101,Proposition 2,,Republican Party,No,29,3,31,63
DeWitt,101,Ballots Cast,,Republican Party,,164,36,205,405
DeWitt,101,Proposition 2,,Republican Party,Undervotes,3,1,5,9
DeWitt,101,Proposition 2,,Republican Party,Overvotes,0,0,0,0
DeWitt,101,Proposition 3,,Republican Party,Yes,147,36,181,364
DeWitt,101,Proposition 3,,Republican Party,No,15,1,16,32
DeWitt,101,Ballots Cast,,Republican Party,,162,37,197,396
DeWitt,101,Proposition 3,,Republican Party,Undervotes,5,0,13,18
DeWitt,101,Proposition 3,,Republican Party,Overvotes,0,0,0,0
DeWitt,101,Proposition 4,,Republican Party,Yes,148,35,186,369
DeWitt,101,Proposition 4,,Republican Party,No,12,2,13,27
DeWitt,101,Ballots Cast,,Republican Party,,160,37,199,396
DeWitt,101,Proposition 4,,Republican Party,Undervotes,7,0,11,18
DeWitt,101,Proposition 4,,Republican Party,Overvotes,0,0,0,0
DeWitt,101,Proposition 5,,Republican Party,Yes,145,31,189,365
DeWitt,101,Proposition 5,,Republican Party,No,18,4,14,36
DeWitt,101,Ballots Cast,,Republican Party,,163,35,203,401
DeWitt,101,Proposition 5,,Republican Party,Undervotes,4,2,7,13
DeWitt,101,Proposition 5,,Republican Party,Overvotes,0,0,0,0
DeWitt,101,Proposition 6,,Republican Party,Yes,154,33,186,373
DeWitt,101,Proposition 6,,Republican Party,No,9,2,17,28
DeWitt,101,Ballots Cast,,Republican Party,,163,35,203,401
DeWitt,101,Proposition 6,,Republican Party,Undervotes,4,2,7,13
DeWitt,101,Proposition 6,,Republican Party,Overvotes,0,0,0,0
DeWitt,101,Proposition 7,,Republican Party,Yes,161,34,193,388
DeWitt,101,Proposition 7,,Republican Party,No,2,0,7,9
DeWitt,101,Ballots Cast,,Republican Party,,163,34,200,397
DeWitt,101,Proposition 7,,Republican Party,Undervotes,4,3,10,17
DeWitt,101,Proposition 7,,Republican Party,Overvotes,0,0,0,0
DeWitt,101,Proposition 8,,Republican Party,Yes,162,35,193,390
DeWitt,101,Proposition 8,,Republican Party,No,1,1,6,8
DeWitt,101,Ballots Cast,,Republican Party,,163,36,199,398
DeWitt,101,Proposition 8,,Republican Party,Undervotes,4,1,11,16
DeWitt,101,Proposition 8,,Republican Party,Overvotes,0,0,0,0
DeWitt,101,Proposition 9,,Republican Party,Yes,150,34,194,378
DeWitt,101,Proposition 9,,Republican Party,No,12,0,7,19
DeWitt,101,Ballots Cast,,Republican Party,,162,34,201,397
DeWitt,101,Proposition 9,,Republican Party,Undervotes,5,3,9,17
DeWitt,101,Proposition 9,,Republican Party,Overvotes,0,0,0,0
DeWitt,101,Proposition 10,,Republican Party,Yes,153,33,174,360
DeWitt,101,Proposition 10,,Republican Party,No,9,1,24,34
DeWitt,101,Ballots Cast,,Republican Party,,162,34,198,394
DeWitt,101,Proposition 10,,Republican Party,Undervotes,5,3,12,20
DeWitt,101,Proposition 10,,Republican Party,Overvotes,0,0,0,0
DeWitt,102,President,,Democratic Party,Amy Klobuchar,0,2,0,2
DeWitt,102,President,,Democratic Party,Joseph R. Biden,33,8,8,49
DeWitt,102,President,,Democratic Party,Michael Bennet,0,0,0,0
DeWitt,102,President,,Democratic Party,Marianne Williamson,0,0,0,0
DeWitt,102,President,,Democratic Party,Michael R. Bloomberg,2,6,5,13
DeWitt,102,President,,Democratic Party,Elizabeth Warren,4,1,1,6
DeWitt,102,President,,Democratic Party,Andrew Yang,0,0,0,0
DeWitt,102,President,,Democratic Party,Tom Steyer,0,0,0,0
DeWitt,102,President,,Democratic Party,Pete Buttigieg,0,0,0,0
DeWitt,102,President,,Democratic Party,Tulsi Gabbard,0,0,0,0
DeWitt,102,President,,Democratic Party,Robby Wells,0,0,0,0
DeWitt,102,President,,Democratic Party,Deval Patrick,0,0,0,0
DeWitt,102,President,,Democratic Party,Bernie Sanders,13,1,2,16
DeWitt,102,President,,Democratic Party,"Roque ""Rocky"" De La Fuente Guerra",1,0,0,1
DeWitt,102,President,,Democratic Party,John K. Delaney,0,0,0,0
DeWitt,102,President,,Democratic Party,Cory Booker,0,0,0,0
DeWitt,102,President,,Democratic Party,Juli√°n Castro,0,1,0,1
DeWitt,102,Ballots Cast,,Democratic Party,,53,19,16,88
DeWitt,102,President,,Democratic Party,Undervotes,0,0,1,1
DeWitt,102,President,,Democratic Party,Overvotes,0,1,0,1
DeWitt,102,United States Senator,,Democratic Party,Victor Hugo Harris,5,1,2,8
DeWitt,102,United States Senator,,Democratic Party,"Annie ""Mam√°"" Garcia",13,0,1,14
DeWitt,102,United States Senator,,Democratic Party,Amanda K. Edwards,3,3,1,7
DeWitt,102,United States Senator,,Democratic Party,Royce West,4,1,1,6
DeWitt,102,United States Senator,,Democratic Party,Adrian Ocegueda,1,1,4,6
DeWitt,102,United States Senator,,Democratic Party,D.R. Hunter,0,0,0,0
DeWitt,102,United States Senator,,Democratic Party,Michael Cooper,2,1,2,5
DeWitt,102,United States Senator,,Democratic Party,Chris Bell,5,1,0,6
DeWitt,102,United States Senator,,Democratic Party,Cristina Tzintzun Ramirez,1,0,1,2
DeWitt,102,United States Senator,,Democratic Party,Sema Hernandez,2,4,1,7
DeWitt,102,United States Senator,,Democratic Party,Jack Daniel Foster Jr,0,0,0,0
DeWitt,102,United States Senator,,Democratic Party,"Mary ""MJ"" Hegar",2,2,1,5
DeWitt,102,Ballots Cast,,Democratic Party,,38,14,14,66
DeWitt,102,United States Senator,,Democratic Party,Undervotes,15,5,3,23
DeWitt,102,United States Senator,,Democratic Party,Overvotes,0,1,0,1
DeWitt,102,"United States Representative, District No. 34",,Democratic Party,Diego Zavala,18,5,7,30
DeWitt,102,"United States Representative, District No. 34",,Democratic Party,Osbert Haro,2,1,1,4
DeWitt,102,"United States Representative, District No. 34",,Democratic Party,Filemon B. Vela,20,9,7,36
DeWitt,102,Ballots Cast,,Democratic Party,,40,15,15,70
DeWitt,102,"United States Representative, District No. 34",,Democratic Party,Undervotes,13,5,2,20
DeWitt,102,"United States Representative, District No. 34",,Democratic Party,Overvotes,0,0,0,0
DeWitt,102,Railroad Commissioner,,Democratic Party,Chrysta Casta√±eda,7,4,4,15
DeWitt,102,Railroad Commissioner,,Democratic Party,Kelly Stone,5,1,3,9
DeWitt,102,Railroad Commissioner,,Democratic Party,Mark Watson,11,5,1,17
DeWitt,102,Railroad Commissioner,,Democratic Party,"Roberto R. ""Beto"" Alonzo",19,5,6,30
DeWitt,102,Ballots Cast,,Democratic Party,,42,15,14,71
DeWitt,102,Railroad Commissioner,,Democratic Party,Undervotes,11,5,3,19
DeWitt,102,Railroad Commissioner,,Democratic Party,Overvotes,0,0,0,0
DeWitt,102,"Chief Justice, Supreme Court",,Democratic Party,Jerry Zimmerer,11,2,5,18
DeWitt,102,"Chief Justice, Supreme Court",,Democratic Party,Amy Clark Meachum,31,12,9,52
DeWitt,102,Ballots Cast,,Democratic Party,,42,14,14,70
DeWitt,102,"Chief Justice, Supreme Court",,Democratic Party,Undervotes,11,6,3,20
DeWitt,102,"Chief Justice, Supreme Court",,Democratic Party,Overvotes,0,0,0,0
DeWitt,102,"Justice, Supreme Court, Place 6 Unexpired Term",,Democratic Party,Larry Praeger,10,3,4,17
DeWitt,102,"Justice, Supreme Court, Place 6 Unexpired Term",,Democratic Party,Kathy Cheng,26,12,10,48
DeWitt,102,Ballots Cast,,Democratic Party,,36,15,14,65
DeWitt,102,"Justice, Supreme Court, Place 6 Unexpired Term",,Democratic Party,Undervotes,17,5,3,25
DeWitt,102,"Justice, Supreme Court, Place 6 Unexpired Term",,Democratic Party,Overvotes,0,0,0,0
DeWitt,102,"Justice, Supreme Court, Place 7",,Democratic Party,Staci Williams,29,10,9,48
DeWitt,102,"Justice, Supreme Court, Place 7",,Democratic Party,Brandy Voss,9,3,5,17
DeWitt,102,Ballots Cast,,Democratic Party,,38,13,14,65
DeWitt,102,"Justice, Supreme Court, Place 7",,Democratic Party,Undervotes,15,7,3,25
DeWitt,102,"Justice, Supreme Court, Place 7",,Democratic Party,Overvotes,0,0,0,0
DeWitt,102,"Justice, Supreme Court, Place 8",,Democratic Party,Peter Kelly,16,5,5,26
DeWitt,102,"Justice, Supreme Court, Place 8",,Democratic Party,Gisela D. Triana,24,9,8,41
DeWitt,102,Ballots Cast,,Democratic Party,,40,14,13,67
DeWitt,102,"Justice, Supreme Court, Place 8",,Democratic Party,Undervotes,13,6,4,23
DeWitt,102,"Justice, Supreme Court, Place 8",,Democratic Party,Overvotes,0,0,0,0
DeWitt,102,"Judge, Court of Criminal Appeals, Place 3",,Democratic Party,Dan Wood,7,2,6,15
DeWitt,102,"Judge, Court of Criminal Appeals, Place 3",,Democratic Party,William Pieratt Demond,6,1,0,7
DeWitt,102,"Judge, Court of Criminal Appeals, Place 3",,Democratic Party,Elizabeth Davis Frizell,24,11,8,43
DeWitt,102,Ballots Cast,,Democratic Party,,37,14,14,65
DeWitt,102,"Judge, Court of Criminal Appeals, Place 3",,Democratic Party,Undervotes,16,6,3,25
DeWitt,102,"Judge, Court of Criminal Appeals, Place 3",,Democratic Party,Overvotes,0,0,0,0
DeWitt,102,"Judge, Court of Criminal Appeals, Place 4",,Democratic Party,Steven Miears,11,4,3,18
DeWitt,102,"Judge, Court of Criminal Appeals, Place 4",,Democratic Party,Tina Clinton,28,10,11,49
DeWitt,102,Ballots Cast,,Democratic Party,,39,14,14,67
DeWitt,102,"Judge, Court of Criminal Appeals, Place 4",,Democratic Party,Undervotes,14,6,3,23
DeWitt,102,"Judge, Court of Criminal Appeals, Place 4",,Democratic Party,Overvotes,0,0,0,0
DeWitt,102,"Judge, Court of Criminal Appeals, Place 9",,Democratic Party,Brandon Birmingham,34,13,14,61
DeWitt,102,Ballots Cast,,Democratic Party,,34,13,14,61
DeWitt,102,"Judge, Court of Criminal Appeals, Place 9",,Democratic Party,Undervotes,19,7,3,29
DeWitt,102,"Judge, Court of Criminal Appeals, Place 9",,Democratic Party,Overvotes,0,0,0,0
DeWitt,102,"State Senator, District 18",,Democratic Party,Michael Antalan,35,12,15,62
DeWitt,102,Ballots Cast,,Democratic Party,,35,12,15,62
DeWitt,102,"State Senator, District 18",,Democratic Party,Undervotes,18,8,2,28
DeWitt,102,"State Senator, District 18",,Democratic Party,Overvotes,0,0,0,0
DeWitt,102,County Chairman,,Democratic Party,Jospeh L. Sheppard,47,15,16,78
DeWitt,102,Ballots Cast,,Democratic Party,,47,15,16,78
DeWitt,102,County Chairman,,Democratic Party,Undervotes,6,5,1,12
DeWitt,102,County Chairman,,Democratic Party,Overvotes,0,0,0,0
DeWitt,102,President,,Republican Party,Zoltan G. Istvan,0,0,0,0
DeWitt,102,President,,Republican Party,Donald J. Trump,23,6,47,76
DeWitt,102,President,,Republican Party,Bill Weld,1,0,0,1
DeWitt,102,President,,Republican Party,Joe Walsh,4,0,0,4
DeWitt,102,President,,Republican Party,"Roque ""Rocky"" De La Fuente Guerra",0,0,0,0
DeWitt,102,President,,Republican Party,Matthew John Matern,2,0,0,2
DeWitt,102,President,,Republican Party,Bob Ely,0,0,0,0
DeWitt,102,President,,Republican Party,Uncommitted,7,0,3,10
DeWitt,102,Ballots Cast,,Republican Party,,37,6,50,93
DeWitt,102,President,,Republican Party,Undervotes,1,0,0,1
DeWitt,102,President,,Republican Party,Overvotes,0,0,0,0
DeWitt,102,United States Senator,,Republican Party,Dwayne Stovall,7,0,19,26
DeWitt,102,United States Senator,,Republican Party,Mark Yancey,4,0,0,4
DeWitt,102,United States Senator,,Republican Party,Virgil Bierschwale,0,0,0,0
DeWitt,102,United States Senator,,Republican Party,John Cornyn,12,6,19,37
DeWitt,102,United States Senator,,Republican Party,John Anthony Castro,10,0,6,16
DeWitt,102,Ballots Cast,,Republican Party,,33,6,44,83
DeWitt,102,United States Senator,,Republican Party,Undervotes,5,0,6,11
DeWitt,102,United States Senator,,Republican Party,Overvotes,0,0,0,0
DeWitt,102,"United States Representative, District No. 34",,Republican Party,Rey Gonzalez,28,2,36,66
DeWitt,102,"United States Representative, District No. 34",,Republican Party,Rod Lingsch,4,4,9,17
DeWitt,102,Ballots Cast,,Republican Party,,32,6,45,83
DeWitt,102,"United States Representative, District No. 34",,Republican Party,Undervotes,6,0,5,11
DeWitt,102,"United States Representative, District No. 34",,Republican Party,Overvotes,0,0,0,0
DeWitt,102,Railroad Commissioner,,Republican Party,Ryan Sitton,11,0,16,27
DeWitt,102,Railroad Commissioner,,Republican Party,"James ""Jim"" Wright",19,4,30,53
DeWitt,102,Ballots Cast,,Republican Party,,30,4,46,80
DeWitt,102,Railroad Commissioner,,Republican Party,Undervotes,8,2,4,14
DeWitt,102,Railroad Commissioner,,Republican Party,Overvotes,0,0,0,0
DeWitt,102,"Chief Justice, Supreme Court",,Republican Party,Nathan Hecht,31,4,45,80
DeWitt,102,Ballots Cast,,Republican Party,,31,4,45,80
DeWitt,102,"Chief Justice, Supreme Court",,Republican Party,Undervotes,7,2,5,14
DeWitt,102,"Chief Justice, Supreme Court",,Republican Party,Overvotes,0,0,0,0
DeWitt,102,"Justice, Supreme Court, Place 6 Unexpired Term",,Republican Party,Jane Bland,30,4,46,80
DeWitt,102,Ballots Cast,,Republican Party,,30,4,46,80
DeWitt,102,"Justice, Supreme Court, Place 6 Unexpired Term",,Republican Party,Undervotes,8,2,4,14
DeWitt,102,"Justice, Supreme Court, Place 6 Unexpired Term",,Republican Party,Overvotes,0,0,0,0
DeWitt,102,"Justice, Supreme Court, Place 7",,Republican Party,Jeff Boyd,27,4,45,76
DeWitt,102,Ballots Cast,,Republican Party,,27,4,45,76
DeWitt,102,"Justice, Supreme Court, Place 7",,Republican Party,Undervotes,11,2,5,18
DeWitt,102,"Justice, Supreme Court, Place 7",,Republican Party,Overvotes,0,0,0,0
DeWitt,102,"Justice, Supreme Court, Place 8",,Republican Party,Brett Busby,28,4,46,78
DeWitt,102,Ballots Cast,,Republican Party,,28,4,46,78
DeWitt,102,"Justice, Supreme Court, Place 8",,Republican Party,Undervotes,10,2,4,16
DeWitt,102,"Justice, Supreme Court, Place 8",,Republican Party,Overvotes,0,0,0,0
DeWitt,102,"Judge, Court of Criminal Appeals, Place 3",,Republican Party,Gina Parker,20,1,34,55
DeWitt,102,"Judge, Court of Criminal Appeals, Place 3",,Republican Party,Bert Richardson,12,3,11,26
DeWitt,102,Ballots Cast,,Republican Party,,32,4,45,81
DeWitt,102,"Judge, Court of Criminal Appeals, Place 3",,Republican Party,Undervotes,6,2,5,13
DeWitt,102,"Judge, Court of Criminal Appeals, Place 3",,Republican Party,Overvotes,0,0,0,0
DeWitt,102,"Judge, Court of Criminal Appeals, Place 4",,Republican Party,Kevin Patrick Yeary,30,4,45,79
DeWitt,102,Ballots Cast,,Republican Party,,30,4,45,79
DeWitt,102,"Judge, Court of Criminal Appeals, Place 4",,Republican Party,Undervotes,8,2,5,15
DeWitt,102,"Judge, Court of Criminal Appeals, Place 4",,Republican Party,Overvotes,0,0,0,0
DeWitt,102,"Judge, Court of Criminal Appeals, Place 9",,Republican Party,David Newell,30,4,46,80
DeWitt,102,Ballots Cast,,Republican Party,,30,4,46,80
DeWitt,102,"Judge, Court of Criminal Appeals, Place 9",,Republican Party,Undervotes,8,2,4,14
DeWitt,102,"Judge, Court of Criminal Appeals, Place 9",,Republican Party,Overvotes,0,0,0,0
DeWitt,102,"State Senator, District 18",,Republican Party,Lois W. Kolkhorst,28,4,45,77
DeWitt,102,Ballots Cast,,Republican Party,,28,4,45,77
DeWitt,102,"State Senator, District 18",,Republican Party,Undervotes,10,2,5,17
DeWitt,102,"State Senator, District 18",,Republican Party,Overvotes,0,0,0,0
DeWitt,102,"State Representative, District 30",,Republican Party,Geanie W. Morrison,23,4,31,58
DeWitt,102,"State Representative, District 30",,Republican Party,Vanessa Hicks-Callaway,10,0,17,27
DeWitt,102,Ballots Cast,,Republican Party,,33,4,48,85
DeWitt,102,"State Representative, District 30",,Republican Party,Undervotes,5,2,2,9
DeWitt,102,"State Representative, District 30",,Republican Party,Overvotes,0,0,0,0
DeWitt,102,"District Attorney, 24th Judicial District",,Republican Party,"Robert C. ""Rob"" Lassman",35,4,43,82
DeWitt,102,Ballots Cast,,Republican Party,,35,4,43,82
DeWitt,102,"District Attorney, 24th Judicial District",,Republican Party,Undervotes,3,2,7,12
DeWitt,102,"District Attorney, 24th Judicial District",,Republican Party,Overvotes,0,0,0,0
DeWitt,102,County Attorney,,Republican Party,Jay Condie,31,4,45,80
DeWitt,102,Ballots Cast,,Republican Party,,31,4,45,80
DeWitt,102,County Attorney,,Republican Party,Undervotes,7,2,5,14
DeWitt,102,County Attorney,,Republican Party,Overvotes,0,0,0,0
DeWitt,102,Sheriff,,Republican Party,Carl R. Bowen,34,4,44,82
DeWitt,102,Ballots Cast,,Republican Party,,34,4,44,82
DeWitt,102,Sheriff,,Republican Party,Undervotes,4,2,6,12
DeWitt,102,Sheriff,,Republican Party,Overvotes,0,0,0,0
DeWitt,102,County Tax Assessor-Collector,,Republican Party,Ashley D. Mraz,27,4,41,72
DeWitt,102,County Tax Assessor-Collector,,Republican Party,Guy Dolan,10,0,9,19
DeWitt,102,Ballots Cast,,Republican Party,,37,4,50,91
DeWitt,102,County Tax Assessor-Collector,,Republican Party,Undervotes,1,2,0,3
DeWitt,102,County Tax Assessor-Collector,,Republican Party,Overvotes,0,0,0,0
DeWitt,102,"County Commissioner, Precinct 1",,Republican Party,Curtis G. Afflerbach,34,4,50,88
DeWitt,102,Ballots Cast,,Republican Party,,34,4,50,88
DeWitt,102,"County Commissioner, Precinct 1",,Republican Party,Undervotes,4,2,0,6
DeWitt,102,"County Commissioner, Precinct 1",,Republican Party,Overvotes,0,0,0,0
DeWitt,102,"Constable, Precinct 1",,Republican Party,Kelly J. Phelps,30,4,45,79
DeWitt,102,Ballots Cast,,Republican Party,,30,4,45,79
DeWitt,102,"Constable, Precinct 1",,Republican Party,Undervotes,8,2,5,15
DeWitt,102,"Constable, Precinct 1",,Republican Party,Overvotes,0,0,0,0
DeWitt,102,County Chairman,,Republican Party,Paul Guidry,30,4,46,80
DeWitt,102,Ballots Cast,,Republican Party,,30,4,46,80
DeWitt,102,County Chairman,,Republican Party,Undervotes,8,2,4,14
DeWitt,102,County Chairman,,Republican Party,Overvotes,0,0,0,0
DeWitt,102,Proposition #1,,Democratic Party,Yes,45,19,17,81
DeWitt,102,Proposition #1,,Democratic Party,No,0,0,0,0
DeWitt,102,Ballots Cast,,Democratic Party,,45,19,17,81
DeWitt,102,Proposition #1,,Democratic Party,Undervotes,8,1,0,9
DeWitt,102,Proposition #1,,Democratic Party,Overvotes,0,0,0,0
DeWitt,102,Proposition #2,,Democratic Party,Yes,42,19,15,76
DeWitt,102,Proposition #2,,Democratic Party,No,0,0,1,1
DeWitt,102,Ballots Cast,,Democratic Party,,42,19,16,77
DeWitt,102,Proposition #2,,Democratic Party,Undervotes,11,1,1,13
DeWitt,102,Proposition #2,,Democratic Party,Overvotes,0,0,0,0
DeWitt,102,Proposition #3,,Democratic Party,Yes,44,19,15,78
DeWitt,102,Proposition #3,,Democratic Party,No,0,0,0,0
DeWitt,102,Ballots Cast,,Democratic Party,,44,19,15,78
DeWitt,102,Proposition #3,,Democratic Party,Undervotes,9,1,2,12
DeWitt,102,Proposition #3,,Democratic Party,Overvotes,0,0,0,0
DeWitt,102,Proposition #4,,Democratic Party,Yes,44,19,16,79
DeWitt,102,Proposition #4,,Democratic Party,No,0,0,0,0
DeWitt,102,Ballots Cast,,Democratic Party,,44,19,16,79
DeWitt,102,Proposition #4,,Democratic Party,Undervotes,9,1,1,11
DeWitt,102,Proposition #4,,Democratic Party,Overvotes,0,0,0,0
DeWitt,102,Proposition #5,,Democratic Party,Yes,44,19,16,79
DeWitt,102,Proposition #5,,Democratic Party,No,1,0,0,1
DeWitt,102,Ballots Cast,,Democratic Party,,45,19,16,80
DeWitt,102,Proposition #5,,Democratic Party,Undervotes,8,1,1,10
DeWitt,102,Proposition #5,,Democratic Party,Overvotes,0,0,0,0
DeWitt,102,Proposition #6,,Democratic Party,Yes,43,19,16,78
DeWitt,102,Proposition #6,,Democratic Party,No,0,0,0,0
DeWitt,102,Ballots Cast,,Democratic Party,,43,19,16,78
DeWitt,102,Proposition #6,,Democratic Party,Undervotes,10,1,1,12
DeWitt,102,Proposition #6,,Democratic Party,Overvotes,0,0,0,0
DeWitt,102,Proposition #7,,Democratic Party,Yes,47,19,16,82
DeWitt,102,Proposition #7,,Democratic Party,No,0,0,0,0
DeWitt,102,Ballots Cast,,Democratic Party,,47,19,16,82
DeWitt,102,Proposition #7,,Democratic Party,Undervotes,6,1,1,8
DeWitt,102,Proposition #7,,Democratic Party,Overvotes,0,0,0,0
DeWitt,102,Proposition #8,,Democratic Party,Yes,45,18,16,79
DeWitt,102,Proposition #8,,Democratic Party,No,0,0,0,0
DeWitt,102,Ballots Cast,,Democratic Party,,45,18,16,79
DeWitt,102,Proposition #8,,Democratic Party,Undervotes,8,2,1,11
DeWitt,102,Proposition #8,,Democratic Party,Overvotes,0,0,0,0
DeWitt,102,Proposition #9,,Democratic Party,Yes,45,19,16,80
DeWitt,102,Proposition #9,,Democratic Party,No,0,0,0,0
DeWitt,102,Ballots Cast,,Democratic Party,,45,19,16,80
DeWitt,102,Proposition #9,,Democratic Party,Undervotes,8,1,1,10
DeWitt,102,Proposition #9,,Democratic Party,Overvotes,0,0,0,0
DeWitt,102,Proposition #10,,Democratic Party,Yes,43,18,13,74
DeWitt,102,Proposition #10,,Democratic Party,No,2,0,1,3
DeWitt,102,Ballots Cast,,Democratic Party,,45,18,14,77
DeWitt,102,Proposition #10,,Democratic Party,Undervotes,8,2,3,13
DeWitt,102,Proposition #10,,Democratic Party,Overvotes,0,0,0,0
DeWitt,102,Proposition #11,,Democratic Party,Yes,44,19,16,79
DeWitt,102,Proposition #11,,Democratic Party,No,2,0,0,2
DeWitt,102,Ballots Cast,,Democratic Party,,46,19,16,81
DeWitt,102,Proposition #11,,Democratic Party,Undervotes,7,1,1,9
DeWitt,102,Proposition #11,,Democratic Party,Overvotes,0,0,0,0
DeWitt,102,Proposition 1,,Republican Party,Yes,26,6,40,72
DeWitt,102,Proposition 1,,Republican Party,No,11,0,8,19
DeWitt,102,Ballots Cast,,Republican Party,,37,6,48,91
DeWitt,102,Proposition 1,,Republican Party,Undervotes,1,0,2,3
DeWitt,102,Proposition 1,,Republican Party,Overvotes,0,0,0,0
DeWitt,102,Proposition 2,,Republican Party,Yes,24,5,40,69
DeWitt,102,Proposition 2,,Republican Party,No,13,1,10,24
DeWitt,102,Ballots Cast,,Republican Party,,37,6,50,93
DeWitt,102,Proposition 2,,Republican Party,Undervotes,1,0,0,1
DeWitt,102,Proposition 2,,Republican Party,Overvotes,0,0,0,0
DeWitt,102,Proposition 3,,Republican Party,Yes,28,6,43,77
DeWitt,102,Proposition 3,,Republican Party,No,5,0,5,10
DeWitt,102,Ballots Cast,,Republican Party,,33,6,48,87
DeWitt,102,Proposition 3,,Republican Party,Undervotes,5,0,2,7
DeWitt,102,Proposition 3,,Republican Party,Overvotes,0,0,0,0
DeWitt,102,Proposition 4,,Republican Party,Yes,26,6,43,75
DeWitt,102,Proposition 4,,Republican Party,No,10,0,5,15
DeWitt,102,Ballots Cast,,Republican Party,,36,6,48,90
DeWitt,102,Proposition 4,,Republican Party,Undervotes,2,0,2,4
DeWitt,102,Proposition 4,,Republican Party,Overvotes,0,0,0,0
DeWitt,102,Proposition 5,,Republican Party,Yes,32,6,44,82
DeWitt,102,Proposition 5,,Republican Party,No,3,0,3,6
DeWitt,102,Ballots Cast,,Republican Party,,35,6,47,88
DeWitt,102,Proposition 5,,Republican Party,Undervotes,3,0,3,6
DeWitt,102,Proposition 5,,Republican Party,Overvotes,0,0,0,0
DeWitt,102,Proposition 6,,Republican Party,Yes,29,6,47,82
DeWitt,102,Proposition 6,,Republican Party,No,6,0,1,7
DeWitt,102,Ballots Cast,,Republican Party,,35,6,48,89
DeWitt,102,Proposition 6,,Republican Party,Undervotes,3,0,2,5
DeWitt,102,Proposition 6,,Republican Party,Overvotes,0,0,0,0
DeWitt,102,Proposition 7,,Republican Party,Yes,34,6,48,88
DeWitt,102,Proposition 7,,Republican Party,No,2,0,1,3
DeWitt,102,Ballots Cast,,Republican Party,,36,6,49,91
DeWitt,102,Proposition 7,,Republican Party,Undervotes,2,0,1,3
DeWitt,102,Proposition 7,,Republican Party,Overvotes,0,0,0,0
DeWitt,102,Proposition 8,,Republican Party,Yes,32,5,46,83
DeWitt,102,Proposition 8,,Republican Party,No,3,1,1,5
DeWitt,102,Ballots Cast,,Republican Party,,35,6,47,88
DeWitt,102,Proposition 8,,Republican Party,Undervotes,3,0,3,6
DeWitt,102,Proposition 8,,Republican Party,Overvotes,0,0,0,0
DeWitt,102,Proposition 9,,Republican Party,Yes,31,5,44,80
DeWitt,102,Proposition 9,,Republican Party,No,5,1,3,9
DeWitt,102,Ballots Cast,,Republican Party,,36,6,47,89
DeWitt,102,Proposition 9,,Republican Party,Undervotes,2,0,3,5
DeWitt,102,Proposition 9,,Republican Party,Overvotes,0,0,0,0
DeWitt,102,Proposition 10,,Republican Party,Yes,29,5,42,76
DeWitt,102,Proposition 10,,Republican Party,No,6,1,6,13
DeWitt,102,Ballots Cast,,Republican Party,,35,6,48,89
DeWitt,102,Proposition 10,,Republican Party,Undervotes,3,0,2,5
DeWitt,102,Proposition 10,,Republican Party,Overvotes,0,0,0,0
DeWitt,201,President,,Democratic Party,Amy Klobuchar,0,0,0,0
DeWitt,201,President,,Democratic Party,Joseph R. Biden,2,2,0,4
DeWitt,201,President,,Democratic Party,Michael Bennet,0,0,0,0
DeWitt,201,President,,Democratic Party,Marianne Williamson,0,0,0,0
DeWitt,201,President,,Democratic Party,Michael R. Bloomberg,2,3,2,7
DeWitt,201,President,,Democratic Party,Elizabeth Warren,0,0,1,1
DeWitt,201,President,,Democratic Party,Andrew Yang,0,0,0,0
DeWitt,201,President,,Democratic Party,Tom Steyer,0,0,0,0
DeWitt,201,President,,Democratic Party,Pete Buttigieg,0,0,0,0
DeWitt,201,President,,Democratic Party,Tulsi Gabbard,0,0,0,0
DeWitt,201,President,,Democratic Party,Robby Wells,0,0,0,0
DeWitt,201,President,,Democratic Party,Deval Patrick,0,0,0,0
DeWitt,201,President,,Democratic Party,Bernie Sanders,4,0,0,4
DeWitt,201,President,,Democratic Party,"Roque ""Rocky"" De La Fuente Guerra",1,0,0,1
DeWitt,201,President,,Democratic Party,John K. Delaney,0,0,0,0
DeWitt,201,President,,Democratic Party,Cory Booker,0,0,0,0
DeWitt,201,President,,Democratic Party,Juli√°n Castro,0,0,0,0
DeWitt,201,Ballots Cast,,Democratic Party,,9,5,3,17
DeWitt,201,President,,Democratic Party,Undervotes,0,0,0,0
DeWitt,201,President,,Democratic Party,Overvotes,0,0,0,0
DeWitt,201,United States Senator,,Democratic Party,Victor Hugo Harris,0,0,0,0
DeWitt,201,United States Senator,,Democratic Party,"Annie ""Mam√°"" Garcia",0,0,0,0
DeWitt,201,United States Senator,,Democratic Party,Amanda K. Edwards,3,0,0,3
DeWitt,201,United States Senator,,Democratic Party,Royce West,0,0,2,2
DeWitt,201,United States Senator,,Democratic Party,Adrian Ocegueda,0,0,0,0
DeWitt,201,United States Senator,,Democratic Party,D.R. Hunter,0,1,0,1
DeWitt,201,United States Senator,,Democratic Party,Michael Cooper,0,0,0,0
DeWitt,201,United States Senator,,Democratic Party,Chris Bell,2,2,0,4
DeWitt,201,United States Senator,,Democratic Party,Cristina Tzintzun Ramirez,0,0,0,0
DeWitt,201,United States Senator,,Democratic Party,Sema Hernandez,1,0,0,1
DeWitt,201,United States Senator,,Democratic Party,Jack Daniel Foster Jr,1,0,0,1
DeWitt,201,United States Senator,,Democratic Party,"Mary ""MJ"" Hegar",1,2,1,4
DeWitt,201,Ballots Cast,,Democratic Party,,8,5,3,16
DeWitt,201,United States Senator,,Democratic Party,Undervotes,1,0,0,1
DeWitt,201,United States Senator,,Democratic Party,Overvotes,0,0,0,0
DeWitt,201,"United States Representative, District No. 34",,Democratic Party,Diego Zavala,1,1,1,3
DeWitt,201,"United States Representative, District No. 34",,Democratic Party,Osbert Haro,2,0,1,3
DeWitt,201,"United States Representative, District No. 34",,Democratic Party,Filemon B. Vela,3,4,1,8
DeWitt,201,Ballots Cast,,Democratic Party,,6,5,3,14
DeWitt,201,"United States Representative, District No. 34",,Democratic Party,Undervotes,3,0,0,3
DeWitt,201,"United States Representative, District No. 34",,Democratic Party,Overvotes,0,0,0,0
DeWitt,201,Railroad Commissioner,,Democratic Party,Chrysta Casta√±eda,0,2,0,2
DeWitt,201,Railroad Commissioner,,Democratic Party,Kelly Stone,3,0,1,4
DeWitt,201,Railroad Commissioner,,Democratic Party,Mark Watson,1,2,2,5
DeWitt,201,Railroad Commissioner,,Democratic Party,"Roberto R. ""Beto"" Alonzo",3,1,0,4
DeWitt,201,Ballots Cast,,Democratic Party,,7,5,3,15
DeWitt,201,Railroad Commissioner,,Democratic Party,Undervotes,2,0,0,2
DeWitt,201,Railroad Commissioner,,Democratic Party,Overvotes,0,0,0,0
DeWitt,201,"Chief Justice, Supreme Court",,Democratic Party,Jerry Zimmerer,4,1,1,6
DeWitt,201,"Chief Justice, Supreme Court",,Democratic Party,Amy Clark Meachum,2,4,2,8
DeWitt,201,Ballots Cast,,Democratic Party,,6,5,3,14
DeWitt,201,"Chief Justice, Supreme Court",,Democratic Party,Undervotes,3,0,0,3
DeWitt,201,"Chief Justice, Supreme Court",,Democratic Party,Overvotes,0,0,0,0
DeWitt,201,"Justice, Supreme Court, Place 6 Unexpired Term",,Democratic Party,Larry Praeger,1,0,1,2
DeWitt,201,"Justice, Supreme Court, Place 6 Unexpired Term",,Democratic Party,Kathy Cheng,5,5,2,12
DeWitt,201,Ballots Cast,,Democratic Party,,6,5,3,14
DeWitt,201,"Justice, Supreme Court, Place 6 Unexpired Term",,Democratic Party,Undervotes,3,0,0,3
DeWitt,201,"Justice, Supreme Court, Place 6 Unexpired Term",,Democratic Party,Overvotes,0,0,0,0
DeWitt,201,"Justice, Supreme Court, Place 7",,Democratic Party,Staci Williams,6,1,2,9
DeWitt,201,"Justice, Supreme Court, Place 7",,Democratic Party,Brandy Voss,0,4,1,5
DeWitt,201,Ballots Cast,,Democratic Party,,6,5,3,14
DeWitt,201,"Justice, Supreme Court, Place 7",,Democratic Party,Undervotes,3,0,0,3
DeWitt,201,"Justice, Supreme Court, Place 7",,Democratic Party,Overvotes,0,0,0,0
DeWitt,201,"Justice, Supreme Court, Place 8",,Democratic Party,Peter Kelly,2,0,2,4
DeWitt,201,"Justice, Supreme Court, Place 8",,Democratic Party,Gisela D. Triana,4,5,1,10
DeWitt,201,Ballots Cast,,Democratic Party,,6,5,3,14
DeWitt,201,"Justice, Supreme Court, Place 8",,Democratic Party,Undervotes,3,0,0,3
DeWitt,201,"Justice, Supreme Court, Place 8",,Democratic Party,Overvotes,0,0,0,0
DeWitt,201,"Judge, Court of Criminal Appeals, Place 3",,Democratic Party,Dan Wood,2,0,1,3
DeWitt,201,"Judge, Court of Criminal Appeals, Place 3",,Democratic Party,William Pieratt Demond,1,1,1,3
DeWitt,201,"Judge, Court of Criminal Appeals, Place 3",,Democratic Party,Elizabeth Davis Frizell,3,4,1,8
DeWitt,201,Ballots Cast,,Democratic Party,,6,5,3,14
DeWitt,201,"Judge, Court of Criminal Appeals, Place 3",,Democratic Party,Undervotes,3,0,0,3
DeWitt,201,"Judge, Court of Criminal Appeals, Place 3",,Democratic Party,Overvotes,0,0,0,0
DeWitt,201,"Judge, Court of Criminal Appeals, Place 4",,Democratic Party,Steven Miears,2,1,2,5
DeWitt,201,"Judge, Court of Criminal Appeals, Place 4",,Democratic Party,Tina Clinton,4,4,1,9
DeWitt,201,Ballots Cast,,Democratic Party,,6,5,3,14
DeWitt,201,"Judge, Court of Criminal Appeals, Place 4",,Democratic Party,Undervotes,3,0,0,3
DeWitt,201,"Judge, Court of Criminal Appeals, Place 4",,Democratic Party,Overvotes,0,0,0,0
DeWitt,201,"Judge, Court of Criminal Appeals, Place 9",,Democratic Party,Brandon Birmingham,6,5,3,14
DeWitt,201,Ballots Cast,,Democratic Party,,6,5,3,14
DeWitt,201,"Judge, Court of Criminal Appeals, Place 9",,Democratic Party,Undervotes,3,0,0,3
DeWitt,201,"Judge, Court of Criminal Appeals, Place 9",,Democratic Party,Overvotes,0,0,0,0
DeWitt,201,"State Senator, District 18",,Democratic Party,Michael Antalan,6,5,3,14
DeWitt,201,Ballots Cast,,Democratic Party,,6,5,3,14
DeWitt,201,"State Senator, District 18",,Democratic Party,Undervotes,3,0,0,3
DeWitt,201,"State Senator, District 18",,Democratic Party,Overvotes,0,0,0,0
DeWitt,201,County Chairman,,Democratic Party,Jospeh L. Sheppard,6,5,3,14
DeWitt,201,Ballots Cast,,Democratic Party,,6,5,3,14
DeWitt,201,County Chairman,,Democratic Party,Undervotes,3,0,0,3
DeWitt,201,County Chairman,,Democratic Party,Overvotes,0,0,0,0
DeWitt,201,President,,Republican Party,Zoltan G. Istvan,0,0,0,0
DeWitt,201,President,,Republican Party,Donald J. Trump,62,18,62,142
DeWitt,201,President,,Republican Party,Bill Weld,0,0,0,0
DeWitt,201,President,,Republican Party,Joe Walsh,0,0,0,0
DeWitt,201,President,,Republican Party,"Roque ""Rocky"" De La Fuente Guerra",0,0,0,0
DeWitt,201,President,,Republican Party,Matthew John Matern,0,0,0,0
DeWitt,201,President,,Republican Party,Bob Ely,0,0,0,0
DeWitt,201,President,,Republican Party,Uncommitted,0,0,1,1
DeWitt,201,Ballots Cast,,Republican Party,,62,18,63,143
DeWitt,201,President,,Republican Party,Undervotes,0,0,1,1
DeWitt,201,President,,Republican Party,Overvotes,0,0,0,0
DeWitt,201,United States Senator,,Republican Party,Dwayne Stovall,16,2,24,42
DeWitt,201,United States Senator,,Republican Party,Mark Yancey,4,0,3,7
DeWitt,201,United States Senator,,Republican Party,Virgil Bierschwale,0,0,0,0
DeWitt,201,United States Senator,,Republican Party,John Cornyn,37,16,30,83
DeWitt,201,United States Senator,,Republican Party,John Anthony Castro,2,0,1,3
DeWitt,201,Ballots Cast,,Republican Party,,59,18,58,135
DeWitt,201,United States Senator,,Republican Party,Undervotes,3,0,6,9
DeWitt,201,United States Senator,,Republican Party,Overvotes,0,0,0,0
DeWitt,201,"United States Representative, District No. 34",,Republican Party,Rey Gonzalez,27,7,32,66
DeWitt,201,"United States Representative, District No. 34",,Republican Party,Rod Lingsch,29,9,17,55
DeWitt,201,Ballots Cast,,Republican Party,,56,16,49,121
DeWitt,201,"United States Representative, District No. 34",,Republican Party,Undervotes,6,2,15,23
DeWitt,201,"United States Representative, District No. 34",,Republican Party,Overvotes,0,0,0,0
DeWitt,201,Railroad Commissioner,,Republican Party,Ryan Sitton,20,8,22,50
DeWitt,201,Railroad Commissioner,,Republican Party,"James ""Jim"" Wright",33,7,30,70
DeWitt,201,Ballots Cast,,Republican Party,,53,15,52,120
DeWitt,201,Railroad Commissioner,,Republican Party,Undervotes,9,2,12,23
DeWitt,201,Railroad Commissioner,,Republican Party,Overvotes,0,1,0,1
DeWitt,201,"Chief Justice, Supreme Court",,Republican Party,Nathan Hecht,53,17,54,124
DeWitt,201,Ballots Cast,,Republican Party,,53,17,54,124
DeWitt,201,"Chief Justice, Supreme Court",,Republican Party,Undervotes,9,1,10,20
DeWitt,201,"Chief Justice, Supreme Court",,Republican Party,Overvotes,0,0,0,0
DeWitt,201,"Justice, Supreme Court, Place 6 Unexpired Term",,Republican Party,Jane Bland,54,16,52,122
DeWitt,201,Ballots Cast,,Republican Party,,54,16,52,122
DeWitt,201,"Justice, Supreme Court, Place 6 Unexpired Term",,Republican Party,Undervotes,8,2,12,22
DeWitt,201,"Justice, Supreme Court, Place 6 Unexpired Term",,Republican Party,Overvotes,0,0,0,0
DeWitt,201,"Justice, Supreme Court, Place 7",,Republican Party,Jeff Boyd,51,16,51,118
DeWitt,201,Ballots Cast,,Republican Party,,51,16,51,118
DeWitt,201,"Justice, Supreme Court, Place 7",,Republican Party,Undervotes,11,2,13,26
DeWitt,201,"Justice, Supreme Court, Place 7",,Republican Party,Overvotes,0,0,0,0
DeWitt,201,"Justice, Supreme Court, Place 8",,Republican Party,Brett Busby,50,16,51,117
DeWitt,201,Ballots Cast,,Republican Party,,50,16,51,117
DeWitt,201,"Justice, Supreme Court, Place 8",,Republican Party,Undervotes,12,2,13,27
DeWitt,201,"Justice, Supreme Court, Place 8",,Republican Party,Overvotes,0,0,0,0
DeWitt,201,"Judge, Court of Criminal Appeals, Place 3",,Republican Party,Gina Parker,24,7,29,60
DeWitt,201,"Judge, Court of Criminal Appeals, Place 3",,Republican Party,Bert Richardson,27,6,21,54
DeWitt,201,Ballots Cast,,Republican Party,,51,13,50,114
DeWitt,201,"Judge, Court of Criminal Appeals, Place 3",,Republican Party,Undervotes,11,5,14,30
DeWitt,201,"Judge, Court of Criminal Appeals, Place 3",,Republican Party,Overvotes,0,0,0,0
DeWitt,201,"Judge, Court of Criminal Appeals, Place 4",,Republican Party,Kevin Patrick Yeary,50,16,52,118
DeWitt,201,Ballots Cast,,Republican Party,,50,16,52,118
DeWitt,201,"Judge, Court of Criminal Appeals, Place 4",,Republican Party,Undervotes,12,2,12,26
DeWitt,201,"Judge, Court of Criminal Appeals, Place 4",,Republican Party,Overvotes,0,0,0,0
DeWitt,201,"Judge, Court of Criminal Appeals, Place 9",,Republican Party,David Newell,51,16,52,119
DeWitt,201,Ballots Cast,,Republican Party,,51,16,52,119
DeWitt,201,"Judge, Court of Criminal Appeals, Place 9",,Republican Party,Undervotes,11,2,12,25
DeWitt,201,"Judge, Court of Criminal Appeals, Place 9",,Republican Party,Overvotes,0,0,0,0
DeWitt,201,"State Senator, District 18",,Republican Party,Lois W. Kolkhorst,57,16,53,126
DeWitt,201,Ballots Cast,,Republican Party,,57,16,53,126
DeWitt,201,"State Senator, District 18",,Republican Party,Undervotes,5,2,11,18
DeWitt,201,"State Senator, District 18",,Republican Party,Overvotes,0,0,0,0
DeWitt,201,"State Representative, District 30",,Republican Party,Geanie W. Morrison,51,15,51,117
DeWitt,201,"State Representative, District 30",,Republican Party,Vanessa Hicks-Callaway,8,3,10,21
DeWitt,201,Ballots Cast,,Republican Party,,59,18,61,138
DeWitt,201,"State Representative, District 30",,Republican Party,Undervotes,3,0,3,6
DeWitt,201,"State Representative, District 30",,Republican Party,Overvotes,0,0,0,0
DeWitt,201,"District Attorney, 24th Judicial District",,Republican Party,"Robert C. ""Rob"" Lassman",52,15,56,123
DeWitt,201,Ballots Cast,,Republican Party,,52,15,56,123
DeWitt,201,"District Attorney, 24th Judicial District",,Republican Party,Undervotes,10,3,8,21
DeWitt,201,"District Attorney, 24th Judicial District",,Republican Party,Overvotes,0,0,0,0
DeWitt,201,County Attorney,,Republican Party,Jay Condie,48,18,60,126
DeWitt,201,Ballots Cast,,Republican Party,,48,18,60,126
DeWitt,201,County Attorney,,Republican Party,Undervotes,14,0,4,18
DeWitt,201,County Attorney,,Republican Party,Overvotes,0,0,0,0
DeWitt,201,Sheriff,,Republican Party,Carl R. Bowen,52,17,61,130
DeWitt,201,Ballots Cast,,Republican Party,,52,17,61,130
DeWitt,201,Sheriff,,Republican Party,Undervotes,10,1,3,14
DeWitt,201,Sheriff,,Republican Party,Overvotes,0,0,0,0
DeWitt,201,County Tax Assessor-Collector,,Republican Party,Ashley D. Mraz,48,16,55,119
DeWitt,201,County Tax Assessor-Collector,,Republican Party,Guy Dolan,12,2,8,22
DeWitt,201,Ballots Cast,,Republican Party,,60,18,63,141
DeWitt,201,County Tax Assessor-Collector,,Republican Party,Undervotes,2,0,1,3
DeWitt,201,County Tax Assessor-Collector,,Republican Party,Overvotes,0,0,0,0
DeWitt,201,"Constable, Precinct 1",,Republican Party,Kelly J. Phelps,55,16,54,125
DeWitt,201,Ballots Cast,,Republican Party,,55,16,54,125
DeWitt,201,"Constable, Precinct 1",,Republican Party,Undervotes,7,2,10,19
DeWitt,201,"Constable, Precinct 1",,Republican Party,Overvotes,0,0,0,0
DeWitt,201,County Chairman,,Republican Party,Paul Guidry,52,18,53,123
DeWitt,201,Ballots Cast,,Republican Party,,52,18,53,123
DeWitt,201,County Chairman,,Republican Party,Undervotes,10,0,11,21
DeWitt,201,County Chairman,,Republican Party,Overvotes,0,0,0,0
DeWitt,201,Proposition #1,,Democratic Party,Yes,8,5,3,16
DeWitt,201,Proposition #1,,Democratic Party,No,1,0,0,1
DeWitt,201,Ballots Cast,,Democratic Party,,9,5,3,17
DeWitt,201,Proposition #1,,Democratic Party,Undervotes,0,0,0,0
DeWitt,201,Proposition #1,,Democratic Party,Overvotes,0,0,0,0
DeWitt,201,Proposition #2,,Democratic Party,Yes,8,5,3,16
DeWitt,201,Proposition #2,,Democratic Party,No,1,0,0,1
DeWitt,201,Ballots Cast,,Democratic Party,,9,5,3,17
DeWitt,201,Proposition #2,,Democratic Party,Undervotes,0,0,0,0
DeWitt,201,Proposition #2,,Democratic Party,Overvotes,0,0,0,0
DeWitt,201,Proposition #3,,Democratic Party,Yes,8,5,3,16
DeWitt,201,Proposition #3,,Democratic Party,No,1,0,0,1
DeWitt,201,Ballots Cast,,Democratic Party,,9,5,3,17
DeWitt,201,Proposition #3,,Democratic Party,Undervotes,0,0,0,0
DeWitt,201,Proposition #3,,Democratic Party,Overvotes,0,0,0,0
DeWitt,201,Proposition #4,,Democratic Party,Yes,7,5,3,15
DeWitt,201,Proposition #4,,Democratic Party,No,2,0,0,2
DeWitt,201,Ballots Cast,,Democratic Party,,9,5,3,17
DeWitt,201,Proposition #4,,Democratic Party,Undervotes,0,0,0,0
DeWitt,201,Proposition #4,,Democratic Party,Overvotes,0,0,0,0
DeWitt,201,Proposition #5,,Democratic Party,Yes,8,5,3,16
DeWitt,201,Proposition #5,,Democratic Party,No,1,0,0,1
DeWitt,201,Ballots Cast,,Democratic Party,,9,5,3,17
DeWitt,201,Proposition #5,,Democratic Party,Undervotes,0,0,0,0
DeWitt,201,Proposition #5,,Democratic Party,Overvotes,0,0,0,0
DeWitt,201,Proposition #6,,Democratic Party,Yes,8,5,3,16
DeWitt,201,Proposition #6,,Democratic Party,No,1,0,0,1
DeWitt,201,Ballots Cast,,Democratic Party,,9,5,3,17
DeWitt,201,Proposition #6,,Democratic Party,Undervotes,0,0,0,0
DeWitt,201,Proposition #6,,Democratic Party,Overvotes,0,0,0,0
DeWitt,201,Proposition #7,,Democratic Party,Yes,7,5,3,15
DeWitt,201,Proposition #7,,Democratic Party,No,2,0,0,2
DeWitt,201,Ballots Cast,,Democratic Party,,9,5,3,17
DeWitt,201,Proposition #7,,Democratic Party,Undervotes,0,0,0,0
DeWitt,201,Proposition #7,,Democratic Party,Overvotes,0,0,0,0
DeWitt,201,Proposition #8,,Democratic Party,Yes,8,5,3,16
DeWitt,201,Proposition #8,,Democratic Party,No,1,0,0,1
DeWitt,201,Ballots Cast,,Democratic Party,,9,5,3,17
DeWitt,201,Proposition #8,,Democratic Party,Undervotes,0,0,0,0
DeWitt,201,Proposition #8,,Democratic Party,Overvotes,0,0,0,0
DeWitt,201,Proposition #9,,Democratic Party,Yes,7,5,3,15
DeWitt,201,Proposition #9,,Democratic Party,No,2,0,0,2
DeWitt,201,Ballots Cast,,Democratic Party,,9,5,3,17
DeWitt,201,Proposition #9,,Democratic Party,Undervotes,0,0,0,0
DeWitt,201,Proposition #9,,Democratic Party,Overvotes,0,0,0,0
DeWitt,201,Proposition #10,,Democratic Party,Yes,7,5,2,14
DeWitt,201,Proposition #10,,Democratic Party,No,2,0,1,3
DeWitt,201,Ballots Cast,,Democratic Party,,9,5,3,17
DeWitt,201,Proposition #10,,Democratic Party,Undervotes,0,0,0,0
DeWitt,201,Proposition #10,,Democratic Party,Overvotes,0,0,0,0
DeWitt,201,Proposition #11,,Democratic Party,Yes,6,5,2,13
DeWitt,201,Proposition #11,,Democratic Party,No,3,0,1,4
DeWitt,201,Ballots Cast,,Democratic Party,,9,5,3,17
DeWitt,201,Proposition #11,,Democratic Party,Undervotes,0,0,0,0
DeWitt,201,Proposition #11,,Democratic Party,Overvotes,0,0,0,0
DeWitt,201,Proposition 1,,Republican Party,Yes,51,17,59,127
DeWitt,201,Proposition 1,,Republican Party,No,10,1,3,14
DeWitt,201,Ballots Cast,,Republican Party,,61,18,62,141
DeWitt,201,Proposition 1,,Republican Party,Undervotes,1,0,2,3
DeWitt,201,Proposition 1,,Republican Party,Overvotes,0,0,0,0
DeWitt,201,Proposition 2,,Republican Party,Yes,49,18,53,120
DeWitt,201,Proposition 2,,Republican Party,No,12,0,9,21
DeWitt,201,Ballots Cast,,Republican Party,,61,18,62,141
DeWitt,201,Proposition 2,,Republican Party,Undervotes,1,0,2,3
DeWitt,201,Proposition 2,,Republican Party,Overvotes,0,0,0,0
DeWitt,201,Proposition 3,,Republican Party,Yes,54,18,52,124
DeWitt,201,Proposition 3,,Republican Party,No,6,0,6,12
DeWitt,201,Ballots Cast,,Republican Party,,60,18,58,136
DeWitt,201,Proposition 3,,Republican Party,Undervotes,2,0,6,8
DeWitt,201,Proposition 3,,Republican Party,Overvotes,0,0,0,0
DeWitt,201,Proposition 4,,Republican Party,Yes,59,18,58,135
DeWitt,201,Proposition 4,,Republican Party,No,2,0,2,4
DeWitt,201,Ballots Cast,,Republican Party,,61,18,60,139
DeWitt,201,Proposition 4,,Republican Party,Undervotes,1,0,4,5
DeWitt,201,Proposition 4,,Republican Party,Overvotes,0,0,0,0
DeWitt,201,Proposition 5,,Republican Party,Yes,53,17,56,126
DeWitt,201,Proposition 5,,Republican Party,No,7,1,2,10
DeWitt,201,Ballots Cast,,Republican Party,,60,18,58,136
DeWitt,201,Proposition 5,,Republican Party,Undervotes,2,0,6,8
DeWitt,201,Proposition 5,,Republican Party,Overvotes,0,0,0,0
DeWitt,201,Proposition 6,,Republican Party,Yes,60,18,56,134
DeWitt,201,Proposition 6,,Republican Party,No,0,0,5,5
DeWitt,201,Ballots Cast,,Republican Party,,60,18,61,139
DeWitt,201,Proposition 6,,Republican Party,Undervotes,2,0,3,5
DeWitt,201,Proposition 6,,Republican Party,Overvotes,0,0,0,0
DeWitt,201,Proposition 7,,Republican Party,Yes,60,18,61,139
DeWitt,201,Proposition 7,,Republican Party,No,0,0,0,0
DeWitt,201,Ballots Cast,,Republican Party,,60,18,61,139
DeWitt,201,Proposition 7,,Republican Party,Undervotes,2,0,3,5
DeWitt,201,Proposition 7,,Republican Party,Overvotes,0,0,0,0
DeWitt,201,Proposition 8,,Republican Party,Yes,60,18,60,138
DeWitt,201,Proposition 8,,Republican Party,No,1,0,0,1
DeWitt,201,Ballots Cast,,Republican Party,,61,18,60,139
DeWitt,201,Proposition 8,,Republican Party,Undervotes,1,0,4,5
DeWitt,201,Proposition 8,,Republican Party,Overvotes,0,0,0,0
DeWitt,201,Proposition 9,,Republican Party,Yes,58,18,59,135
DeWitt,201,Proposition 9,,Republican Party,No,3,0,3,6
DeWitt,201,Ballots Cast,,Republican Party,,61,18,62,141
DeWitt,201,Proposition 9,,Republican Party,Undervotes,1,0,2,3
DeWitt,201,Proposition 9,,Republican Party,Overvotes,0,0,0,0
DeWitt,201,Proposition 10,,Republican Party,Yes,56,12,57,125
DeWitt,201,Proposition 10,,Republican Party,No,2,6,3,11
DeWitt,201,Ballots Cast,,Republican Party,,58,18,60,136
DeWitt,201,Proposition 10,,Republican Party,Undervotes,4,0,4,8
DeWitt,201,Proposition 10,,Republican Party,Overvotes,0,0,0,0
DeWitt,202,President,,Democratic Party,Amy Klobuchar,1,0,1,2
DeWitt,202,President,,Democratic Party,Joseph R. Biden,15,6,5,26
DeWitt,202,President,,Democratic Party,Michael Bennet,1,0,0,1
DeWitt,202,President,,Democratic Party,Marianne Williamson,0,0,0,0
DeWitt,202,President,,Democratic Party,Michael R. Bloomberg,5,2,0,7
DeWitt,202,President,,Democratic Party,Elizabeth Warren,4,0,1,5
DeWitt,202,President,,Democratic Party,Andrew Yang,0,0,0,0
DeWitt,202,President,,Democratic Party,Tom Steyer,2,0,0,2
DeWitt,202,President,,Democratic Party,Pete Buttigieg,0,3,1,4
DeWitt,202,President,,Democratic Party,Tulsi Gabbard,0,0,0,0
DeWitt,202,President,,Democratic Party,Robby Wells,0,0,0,0
DeWitt,202,President,,Democratic Party,Deval Patrick,0,0,0,0
DeWitt,202,President,,Democratic Party,Bernie Sanders,4,1,3,8
DeWitt,202,President,,Democratic Party,"Roque ""Rocky"" De La Fuente Guerra",0,0,0,0
DeWitt,202,President,,Democratic Party,John K. Delaney,0,0,0,0
DeWitt,202,President,,Democratic Party,Cory Booker,0,0,0,0
DeWitt,202,President,,Democratic Party,Juli√°n Castro,0,0,0,0
DeWitt,202,Ballots Cast,,Democratic Party,,32,12,11,55
DeWitt,202,President,,Democratic Party,Undervotes,0,0,0,0
DeWitt,202,President,,Democratic Party,Overvotes,0,0,0,0
DeWitt,202,United States Senator,,Democratic Party,Victor Hugo Harris,2,0,0,2
DeWitt,202,United States Senator,,Democratic Party,"Annie ""Mam√°"" Garcia",9,0,2,11
DeWitt,202,United States Senator,,Democratic Party,Amanda K. Edwards,6,1,1,8
DeWitt,202,United States Senator,,Democratic Party,Royce West,0,0,0,0
DeWitt,202,United States Senator,,Democratic Party,Adrian Ocegueda,0,0,1,1
DeWitt,202,United States Senator,,Democratic Party,D.R. Hunter,0,0,0,0
DeWitt,202,United States Senator,,Democratic Party,Michael Cooper,1,5,0,6
DeWitt,202,United States Senator,,Democratic Party,Chris Bell,1,2,0,3
DeWitt,202,United States Senator,,Democratic Party,Cristina Tzintzun Ramirez,3,1,0,4
DeWitt,202,United States Senator,,Democratic Party,Sema Hernandez,0,0,1,1
DeWitt,202,United States Senator,,Democratic Party,Jack Daniel Foster Jr,0,0,0,0
DeWitt,202,United States Senator,,Democratic Party,"Mary ""MJ"" Hegar",7,3,3,13
DeWitt,202,Ballots Cast,,Democratic Party,,29,12,8,49
DeWitt,202,United States Senator,,Democratic Party,Undervotes,3,0,3,6
DeWitt,202,United States Senator,,Democratic Party,Overvotes,0,0,0,0
DeWitt,202,"United States Representative, District No. 34",,Democratic Party,Diego Zavala,18,2,1,21
DeWitt,202,"United States Representative, District No. 34",,Democratic Party,Osbert Haro,4,1,0,5
DeWitt,202,"United States Representative, District No. 34",,Democratic Party,Filemon B. Vela,5,9,6,20
DeWitt,202,Ballots Cast,,Democratic Party,,27,12,7,46
DeWitt,202,"United States Representative, District No. 34",,Democratic Party,Undervotes,5,0,4,9
DeWitt,202,"United States Representative, District No. 34",,Democratic Party,Overvotes,0,0,0,0
DeWitt,202,Railroad Commissioner,,Democratic Party,Chrysta Casta√±eda,9,2,0,11
DeWitt,202,Railroad Commissioner,,Democratic Party,Kelly Stone,8,3,4,15
DeWitt,202,Railroad Commissioner,,Democratic Party,Mark Watson,4,4,2,10
DeWitt,202,Railroad Commissioner,,Democratic Party,"Roberto R. ""Beto"" Alonzo",7,1,2,10
DeWitt,202,Ballots Cast,,Democratic Party,,28,10,8,46
DeWitt,202,Railroad Commissioner,,Democratic Party,Undervotes,4,2,3,9
DeWitt,202,Railroad Commissioner,,Democratic Party,Overvotes,0,0,0,0
DeWitt,202,"Chief Justice, Supreme Court",,Democratic Party,Jerry Zimmerer,7,2,2,11
DeWitt,202,"Chief Justice, Supreme Court",,Democratic Party,Amy Clark Meachum,20,8,5,33
DeWitt,202,Ballots Cast,,Democratic Party,,27,10,7,44
DeWitt,202,"Chief Justice, Supreme Court",,Democratic Party,Undervotes,5,2,4,11
DeWitt,202,"Chief Justice, Supreme Court",,Democratic Party,Overvotes,0,0,0,0
DeWitt,202,"Justice, Supreme Court, Place 6 Unexpired Term",,Democratic Party,Larry Praeger,9,1,2,12
DeWitt,202,"Justice, Supreme Court, Place 6 Unexpired Term",,Democratic Party,Kathy Cheng,19,9,6,34
DeWitt,202,Ballots Cast,,Democratic Party,,28,10,8,46
DeWitt,202,"Justice, Supreme Court, Place 6 Unexpired Term",,Democratic Party,Undervotes,4,2,3,9
DeWitt,202,"Justice, Supreme Court, Place 6 Unexpired Term",,Democratic Party,Overvotes,0,0,0,0
DeWitt,202,"Justice, Supreme Court, Place 7",,Democratic Party,Staci Williams,18,5,4,27
DeWitt,202,"Justice, Supreme Court, Place 7",,Democratic Party,Brandy Voss,9,5,2,16
DeWitt,202,Ballots Cast,,Democratic Party,,27,10,6,43
DeWitt,202,"Justice, Supreme Court, Place 7",,Democratic Party,Undervotes,5,2,5,12
DeWitt,202,"Justice, Supreme Court, Place 7",,Democratic Party,Overvotes,0,0,0,0
DeWitt,202,"Justice, Supreme Court, Place 8",,Democratic Party,Peter Kelly,11,6,2,19
DeWitt,202,"Justice, Supreme Court, Place 8",,Democratic Party,Gisela D. Triana,18,4,6,28
DeWitt,202,Ballots Cast,,Democratic Party,,29,10,8,47
DeWitt,202,"Justice, Supreme Court, Place 8",,Democratic Party,Undervotes,3,2,3,8
DeWitt,202,"Justice, Supreme Court, Place 8",,Democratic Party,Overvotes,0,0,0,0
DeWitt,202,"Judge, Court of Criminal Appeals, Place 3",,Democratic Party,Dan Wood,5,2,1,8
DeWitt,202,"Judge, Court of Criminal Appeals, Place 3",,Democratic Party,William Pieratt Demond,2,1,0,3
DeWitt,202,"Judge, Court of Criminal Appeals, Place 3",,Democratic Party,Elizabeth Davis Frizell,22,7,6,35
DeWitt,202,Ballots Cast,,Democratic Party,,29,10,7,46
DeWitt,202,"Judge, Court of Criminal Appeals, Place 3",,Democratic Party,Undervotes,3,2,4,9
DeWitt,202,"Judge, Court of Criminal Appeals, Place 3",,Democratic Party,Overvotes,0,0,0,0
DeWitt,202,"Judge, Court of Criminal Appeals, Place 4",,Democratic Party,Steven Miears,9,2,3,14
DeWitt,202,"Judge, Court of Criminal Appeals, Place 4",,Democratic Party,Tina Clinton,20,8,5,33
DeWitt,202,Ballots Cast,,Democratic Party,,29,10,8,47
DeWitt,202,"Judge, Court of Criminal Appeals, Place 4",,Democratic Party,Undervotes,3,2,3,8
DeWitt,202,"Judge, Court of Criminal Appeals, Place 4",,Democratic Party,Overvotes,0,0,0,0
DeWitt,202,"Judge, Court of Criminal Appeals, Place 9",,Democratic Party,Brandon Birmingham,24,10,5,39
DeWitt,202,Ballots Cast,,Democratic Party,,24,10,5,39
DeWitt,202,"Judge, Court of Criminal Appeals, Place 9",,Democratic Party,Undervotes,8,2,6,16
DeWitt,202,"Judge, Court of Criminal Appeals, Place 9",,Democratic Party,Overvotes,0,0,0,0
DeWitt,202,"State Senator, District 18",,Democratic Party,Michael Antalan,26,10,4,40
DeWitt,202,Ballots Cast,,Democratic Party,,26,10,4,40
DeWitt,202,"State Senator, District 18",,Democratic Party,Undervotes,6,2,7,15
DeWitt,202,"State Senator, District 18",,Democratic Party,Overvotes,0,0,0,0
DeWitt,202,County Chairman,,Democratic Party,Jospeh L. Sheppard,26,9,6,41
DeWitt,202,Ballots Cast,,Democratic Party,,26,9,6,41
DeWitt,202,County Chairman,,Democratic Party,Undervotes,6,3,5,14
DeWitt,202,County Chairman,,Democratic Party,Overvotes,0,0,0,0
DeWitt,202,President,,Republican Party,Zoltan G. Istvan,0,0,0,0
DeWitt,202,President,,Republican Party,Donald J. Trump,127,27,53,207
DeWitt,202,President,,Republican Party,Bill Weld,1,0,0,1
DeWitt,202,President,,Republican Party,Joe Walsh,0,0,0,0
DeWitt,202,President,,Republican Party,"Roque ""Rocky"" De La Fuente Guerra",1,0,0,1
DeWitt,202,President,,Republican Party,Matthew John Matern,0,0,0,0
DeWitt,202,President,,Republican Party,Bob Ely,0,0,0,0
DeWitt,202,President,,Republican Party,Uncommitted,2,2,1,5
DeWitt,202,Ballots Cast,,Republican Party,,131,29,54,214
DeWitt,202,President,,Republican Party,Undervotes,2,1,0,3
DeWitt,202,President,,Republican Party,Overvotes,0,0,0,0
DeWitt,202,United States Senator,,Republican Party,Dwayne Stovall,33,5,12,50
DeWitt,202,United States Senator,,Republican Party,Mark Yancey,5,0,4,9
DeWitt,202,United States Senator,,Republican Party,Virgil Bierschwale,1,0,0,1
DeWitt,202,United States Senator,,Republican Party,John Cornyn,80,24,36,140
DeWitt,202,United States Senator,,Republican Party,John Anthony Castro,8,1,0,9
DeWitt,202,Ballots Cast,,Republican Party,,127,30,52,209
DeWitt,202,United States Senator,,Republican Party,Undervotes,6,0,2,8
DeWitt,202,United States Senator,,Republican Party,Overvotes,0,0,0,0
DeWitt,202,"United States Representative, District No. 34",,Republican Party,Rey Gonzalez,65,12,30,107
DeWitt,202,"United States Representative, District No. 34",,Republican Party,Rod Lingsch,48,12,16,76
DeWitt,202,Ballots Cast,,Republican Party,,113,24,46,183
DeWitt,202,"United States Representative, District No. 34",,Republican Party,Undervotes,20,6,8,34
DeWitt,202,"United States Representative, District No. 34",,Republican Party,Overvotes,0,0,0,0
DeWitt,202,Railroad Commissioner,,Republican Party,Ryan Sitton,47,9,26,82
DeWitt,202,Railroad Commissioner,,Republican Party,"James ""Jim"" Wright",70,14,24,108
DeWitt,202,Ballots Cast,,Republican Party,,117,23,50,190
DeWitt,202,Railroad Commissioner,,Republican Party,Undervotes,16,7,4,27
DeWitt,202,Railroad Commissioner,,Republican Party,Overvotes,0,0,0,0
DeWitt,202,"Chief Justice, Supreme Court",,Republican Party,Nathan Hecht,118,25,48,191
DeWitt,202,Ballots Cast,,Republican Party,,118,25,48,191
DeWitt,202,"Chief Justice, Supreme Court",,Republican Party,Undervotes,15,5,6,26
DeWitt,202,"Chief Justice, Supreme Court",,Republican Party,Overvotes,0,0,0,0
DeWitt,202,"Justice, Supreme Court, Place 6 Unexpired Term",,Republican Party,Jane Bland,117,24,50,191
DeWitt,202,Ballots Cast,,Republican Party,,117,24,50,191
DeWitt,202,"Justice, Supreme Court, Place 6 Unexpired Term",,Republican Party,Undervotes,16,6,4,26
DeWitt,202,"Justice, Supreme Court, Place 6 Unexpired Term",,Republican Party,Overvotes,0,0,0,0
DeWitt,202,"Justice, Supreme Court, Place 7",,Republican Party,Jeff Boyd,118,23,50,191
DeWitt,202,Ballots Cast,,Republican Party,,118,23,50,191
DeWitt,202,"Justice, Supreme Court, Place 7",,Republican Party,Undervotes,15,7,4,26
DeWitt,202,"Justice, Supreme Court, Place 7",,Republican Party,Overvotes,0,0,0,0
DeWitt,202,"Justice, Supreme Court, Place 8",,Republican Party,Brett Busby,117,23,49,189
DeWitt,202,Ballots Cast,,Republican Party,,117,23,49,189
DeWitt,202,"Justice, Supreme Court, Place 8",,Republican Party,Undervotes,16,7,5,28
DeWitt,202,"Justice, Supreme Court, Place 8",,Republican Party,Overvotes,0,0,0,0
DeWitt,202,"Judge, Court of Criminal Appeals, Place 3",,Republican Party,Gina Parker,63,11,33,107
DeWitt,202,"Judge, Court of Criminal Appeals, Place 3",,Republican Party,Bert Richardson,52,13,18,83
DeWitt,202,Ballots Cast,,Republican Party,,115,24,51,190
DeWitt,202,"Judge, Court of Criminal Appeals, Place 3",,Republican Party,Undervotes,18,6,3,27
DeWitt,202,"Judge, Court of Criminal Appeals, Place 3",,Republican Party,Overvotes,0,0,0,0
DeWitt,202,"Judge, Court of Criminal Appeals, Place 4",,Republican Party,Kevin Patrick Yeary,117,23,48,188
DeWitt,202,Ballots Cast,,Republican Party,,117,23,48,188
DeWitt,202,"Judge, Court of Criminal Appeals, Place 4",,Republican Party,Undervotes,16,7,6,29
DeWitt,202,"Judge, Court of Criminal Appeals, Place 4",,Republican Party,Overvotes,0,0,0,0
DeWitt,202,"Judge, Court of Criminal Appeals, Place 9",,Republican Party,David Newell,116,23,49,188
DeWitt,202,Ballots Cast,,Republican Party,,116,23,49,188
DeWitt,202,"Judge, Court of Criminal Appeals, Place 9",,Republican Party,Undervotes,17,7,5,29
DeWitt,202,"Judge, Court of Criminal Appeals, Place 9",,Republican Party,Overvotes,0,0,0,0
DeWitt,202,"State Senator, District 18",,Republican Party,Lois W. Kolkhorst,120,26,51,197
DeWitt,202,Ballots Cast,,Republican Party,,120,26,51,197
DeWitt,202,"State Senator, District 18",,Republican Party,Undervotes,13,4,3,20
DeWitt,202,"State Senator, District 18",,Republican Party,Overvotes,0,0,0,0
DeWitt,202,"State Representative, District 30",,Republican Party,Geanie W. Morrison,104,28,46,178
DeWitt,202,"State Representative, District 30",,Republican Party,Vanessa Hicks-Callaway,26,1,5,32
DeWitt,202,Ballots Cast,,Republican Party,,130,29,51,210
DeWitt,202,"State Representative, District 30",,Republican Party,Undervotes,3,1,3,7
DeWitt,202,"State Representative, District 30",,Republican Party,Overvotes,0,0,0,0
DeWitt,202,"District Attorney, 24th Judicial District",,Republican Party,"Robert C. ""Rob"" Lassman",119,26,49,194
DeWitt,202,Ballots Cast,,Republican Party,,119,26,49,194
DeWitt,202,"District Attorney, 24th Judicial District",,Republican Party,Undervotes,14,4,5,23
DeWitt,202,"District Attorney, 24th Judicial District",,Republican Party,Overvotes,0,0,0,0
DeWitt,202,County Attorney,,Republican Party,Jay Condie,116,28,49,193
DeWitt,202,Ballots Cast,,Republican Party,,116,28,49,193
DeWitt,202,County Attorney,,Republican Party,Undervotes,17,2,5,24
DeWitt,202,County Attorney,,Republican Party,Overvotes,0,0,0,0
DeWitt,202,Sheriff,,Republican Party,Carl R. Bowen,124,26,49,199
DeWitt,202,Ballots Cast,,Republican Party,,124,26,49,199
DeWitt,202,Sheriff,,Republican Party,Undervotes,9,4,5,18
DeWitt,202,Sheriff,,Republican Party,Overvotes,0,0,0,0
DeWitt,202,County Tax Assessor-Collector,,Republican Party,Ashley D. Mraz,100,23,46,169
DeWitt,202,County Tax Assessor-Collector,,Republican Party,Guy Dolan,25,5,5,35
DeWitt,202,Ballots Cast,,Republican Party,,125,28,51,204
DeWitt,202,County Tax Assessor-Collector,,Republican Party,Undervotes,8,1,3,12
DeWitt,202,County Tax Assessor-Collector,,Republican Party,Overvotes,0,1,0,1
DeWitt,202,"Constable, Precinct 1",,Republican Party,Kelly J. Phelps,114,23,49,186
DeWitt,202,Ballots Cast,,Republican Party,,114,23,49,186
DeWitt,202,"Constable, Precinct 1",,Republican Party,Undervotes,19,7,5,31
DeWitt,202,"Constable, Precinct 1",,Republican Party,Overvotes,0,0,0,0
DeWitt,202,County Chairman,,Republican Party,Paul Guidry,118,26,50,194
DeWitt,202,Ballots Cast,,Republican Party,,118,26,50,194
DeWitt,202,County Chairman,,Republican Party,Undervotes,15,4,4,23
DeWitt,202,County Chairman,,Republican Party,Overvotes,0,0,0,0
DeWitt,202,Proposition #1,,Democratic Party,Yes,32,11,8,51
DeWitt,202,Proposition #1,,Democratic Party,No,0,1,3,4
DeWitt,202,Ballots Cast,,Democratic Party,,32,12,11,55
DeWitt,202,Proposition #1,,Democratic Party,Undervotes,0,0,0,0
DeWitt,202,Proposition #1,,Democratic Party,Overvotes,0,0,0,0
DeWitt,202,Proposition #2,,Democratic Party,Yes,31,11,8,50
DeWitt,202,Proposition #2,,Democratic Party,No,0,1,3,4
DeWitt,202,Ballots Cast,,Democratic Party,,31,12,11,54
DeWitt,202,Proposition #2,,Democratic Party,Undervotes,1,0,0,1
DeWitt,202,Proposition #2,,Democratic Party,Overvotes,0,0,0,0
DeWitt,202,Proposition #3,,Democratic Party,Yes,32,11,9,52
DeWitt,202,Proposition #3,,Democratic Party,No,0,1,2,3
DeWitt,202,Ballots Cast,,Democratic Party,,32,12,11,55
DeWitt,202,Proposition #3,,Democratic Party,Undervotes,0,0,0,0
DeWitt,202,Proposition #3,,Democratic Party,Overvotes,0,0,0,0
DeWitt,202,Proposition #4,,Democratic Party,Yes,29,11,8,48
DeWitt,202,Proposition #4,,Democratic Party,No,2,1,3,6
DeWitt,202,Ballots Cast,,Democratic Party,,31,12,11,54
DeWitt,202,Proposition #4,,Democratic Party,Undervotes,1,0,0,1
DeWitt,202,Proposition #4,,Democratic Party,Overvotes,0,0,0,0
DeWitt,202,Proposition #5,,Democratic Party,Yes,31,12,8,51
DeWitt,202,Proposition #5,,Democratic Party,No,1,0,2,3
DeWitt,202,Ballots Cast,,Democratic Party,,32,12,10,54
DeWitt,202,Proposition #5,,Democratic Party,Undervotes,0,0,1,1
DeWitt,202,Proposition #5,,Democratic Party,Overvotes,0,0,0,0
DeWitt,202,Proposition #6,,Democratic Party,Yes,31,12,9,52
DeWitt,202,Proposition #6,,Democratic Party,No,0,0,2,2
DeWitt,202,Ballots Cast,,Democratic Party,,31,12,11,54
DeWitt,202,Proposition #6,,Democratic Party,Undervotes,1,0,0,1
DeWitt,202,Proposition #6,,Democratic Party,Overvotes,0,0,0,0
DeWitt,202,Proposition #7,,Democratic Party,Yes,27,11,8,46
DeWitt,202,Proposition #7,,Democratic Party,No,3,1,3,7
DeWitt,202,Ballots Cast,,Democratic Party,,30,12,11,53
DeWitt,202,Proposition #7,,Democratic Party,Undervotes,2,0,0,2
DeWitt,202,Proposition #7,,Democratic Party,Overvotes,0,0,0,0
DeWitt,202,Proposition #8,,Democratic Party,Yes,31,12,7,50
DeWitt,202,Proposition #8,,Democratic Party,No,1,0,3,4
DeWitt,202,Ballots Cast,,Democratic Party,,32,12,10,54
DeWitt,202,Proposition #8,,Democratic Party,Undervotes,0,0,1,1
DeWitt,202,Proposition #8,,Democratic Party,Overvotes,0,0,0,0
DeWitt,202,Proposition #9,,Democratic Party,Yes,30,12,8,50
DeWitt,202,Proposition #9,,Democratic Party,No,1,0,2,3
DeWitt,202,Ballots Cast,,Democratic Party,,31,12,10,53
DeWitt,202,Proposition #9,,Democratic Party,Undervotes,1,0,1,2
DeWitt,202,Proposition #9,,Democratic Party,Overvotes,0,0,0,0
DeWitt,202,Proposition #10,,Democratic Party,Yes,28,11,9,48
DeWitt,202,Proposition #10,,Democratic Party,No,1,1,2,4
DeWitt,202,Ballots Cast,,Democratic Party,,29,12,11,52
DeWitt,202,Proposition #10,,Democratic Party,Undervotes,3,0,0,3
DeWitt,202,Proposition #10,,Democratic Party,Overvotes,0,0,0,0
DeWitt,202,Proposition #11,,Democratic Party,Yes,27,12,9,48
DeWitt,202,Proposition #11,,Democratic Party,No,5,0,2,7
DeWitt,202,Ballots Cast,,Democratic Party,,32,12,11,55
DeWitt,202,Proposition #11,,Democratic Party,Undervotes,0,0,0,0
DeWitt,202,Proposition #11,,Democratic Party,Overvotes,0,0,0,0
DeWitt,202,Proposition 1,,Republican Party,Yes,115,23,48,186
DeWitt,202,Proposition 1,,Republican Party,No,15,6,6,27
DeWitt,202,Ballots Cast,,Republican Party,,130,29,54,213
DeWitt,202,Proposition 1,,Republican Party,Undervotes,3,1,0,4
DeWitt,202,Proposition 1,,Republican Party,Overvotes,0,0,0,0
DeWitt,202,Proposition 2,,Republican Party,Yes,110,25,47,182
DeWitt,202,Proposition 2,,Republican Party,No,20,5,7,32
DeWitt,202,Ballots Cast,,Republican Party,,130,30,54,214
DeWitt,202,Proposition 2,,Republican Party,Undervotes,3,0,0,3
DeWitt,202,Proposition 2,,Republican Party,Overvotes,0,0,0,0
DeWitt,202,Proposition 3,,Republican Party,Yes,118,27,47,192
DeWitt,202,Proposition 3,,Republican Party,No,11,1,3,15
DeWitt,202,Ballots Cast,,Republican Party,,129,28,50,207
DeWitt,202,Proposition 3,,Republican Party,Undervotes,4,2,4,10
DeWitt,202,Proposition 3,,Republican Party,Overvotes,0,0,0,0
DeWitt,202,Proposition 4,,Republican Party,Yes,123,29,53,205
DeWitt,202,Proposition 4,,Republican Party,No,7,1,0,8
DeWitt,202,Ballots Cast,,Republican Party,,130,30,53,213
DeWitt,202,Proposition 4,,Republican Party,Undervotes,3,0,1,4
DeWitt,202,Proposition 4,,Republican Party,Overvotes,0,0,0,0
DeWitt,202,Proposition 5,,Republican Party,Yes,120,25,47,192
DeWitt,202,Proposition 5,,Republican Party,No,9,2,4,15
DeWitt,202,Ballots Cast,,Republican Party,,129,27,51,207
DeWitt,202,Proposition 5,,Republican Party,Undervotes,4,3,3,10
DeWitt,202,Proposition 5,,Republican Party,Overvotes,0,0,0,0
DeWitt,202,Proposition 6,,Republican Party,Yes,124,27,51,202
DeWitt,202,Proposition 6,,Republican Party,No,3,0,0,3
DeWitt,202,Ballots Cast,,Republican Party,,127,27,51,205
DeWitt,202,Proposition 6,,Republican Party,Undervotes,6,3,3,12
DeWitt,202,Proposition 6,,Republican Party,Overvotes,0,0,0,0
DeWitt,202,Proposition 7,,Republican Party,Yes,130,25,51,206
DeWitt,202,Proposition 7,,Republican Party,No,1,0,0,1
DeWitt,202,Ballots Cast,,Republican Party,,131,25,51,207
DeWitt,202,Proposition 7,,Republican Party,Undervotes,2,5,3,10
DeWitt,202,Proposition 7,,Republican Party,Overvotes,0,0,0,0
DeWitt,202,Proposition 8,,Republican Party,Yes,128,29,51,208
DeWitt,202,Proposition 8,,Republican Party,No,1,0,1,2
DeWitt,202,Ballots Cast,,Republican Party,,129,29,52,210
DeWitt,202,Proposition 8,,Republican Party,Undervotes,4,1,2,7
DeWitt,202,Proposition 8,,Republican Party,Overvotes,0,0,0,0
DeWitt,202,Proposition 9,,Republican Party,Yes,128,26,50,204
DeWitt,202,Proposition 9,,Republican Party,No,3,2,1,6
DeWitt,202,Ballots Cast,,Republican Party,,131,28,51,210
DeWitt,202,Proposition 9,,Republican Party,Undervotes,2,2,3,7
DeWitt,202,Proposition 9,,Republican Party,Overvotes,0,0,0,0
DeWitt,202,Proposition 10,,Republican Party,Yes,121,26,43,190
DeWitt,202,Proposition 10,,Republican Party,No,10,2,9,21
DeWitt,202,Ballots Cast,,Republican Party,,131,28,52,211
DeWitt,202,Proposition 10,,Republican Party,Undervotes,2,2,2,6
DeWitt,202,Proposition 10,,Republican Party,Overvotes,0,0,0,0
DeWitt,203,President,,Democratic Party,Amy Klobuchar,0,1,1,2
DeWitt,203,President,,Democratic Party,Joseph R. Biden,8,3,0,11
DeWitt,203,President,,Democratic Party,Michael Bennet,0,0,0,0
DeWitt,203,President,,Democratic Party,Marianne Williamson,0,0,0,0
DeWitt,203,President,,Democratic Party,Michael R. Bloomberg,6,1,1,8
DeWitt,203,President,,Democratic Party,Elizabeth Warren,2,0,0,2
DeWitt,203,President,,Democratic Party,Andrew Yang,0,0,0,0
DeWitt,203,President,,Democratic Party,Tom Steyer,0,0,1,1
DeWitt,203,President,,Democratic Party,Pete Buttigieg,0,3,3,6
DeWitt,203,President,,Democratic Party,Tulsi Gabbard,0,0,0,0
DeWitt,203,President,,Democratic Party,Robby Wells,0,0,0,0
DeWitt,203,President,,Democratic Party,Deval Patrick,0,0,0,0
DeWitt,203,President,,Democratic Party,Bernie Sanders,2,1,2,5
DeWitt,203,President,,Democratic Party,"Roque ""Rocky"" De La Fuente Guerra",0,0,0,0
DeWitt,203,President,,Democratic Party,John K. Delaney,0,0,0,0
DeWitt,203,President,,Democratic Party,Cory Booker,0,0,0,0
DeWitt,203,President,,Democratic Party,Juli√°n Castro,0,0,0,0
DeWitt,203,Ballots Cast,,Democratic Party,,18,9,8,35
DeWitt,203,President,,Democratic Party,Undervotes,0,0,0,0
DeWitt,203,President,,Democratic Party,Overvotes,0,0,0,0
DeWitt,203,United States Senator,,Democratic Party,Victor Hugo Harris,0,0,1,1
DeWitt,203,United States Senator,,Democratic Party,"Annie ""Mam√°"" Garcia",5,1,1,7
DeWitt,203,United States Senator,,Democratic Party,Amanda K. Edwards,2,0,1,3
DeWitt,203,United States Senator,,Democratic Party,Royce West,0,0,0,0
DeWitt,203,United States Senator,,Democratic Party,Adrian Ocegueda,0,0,1,1
DeWitt,203,United States Senator,,Democratic Party,D.R. Hunter,1,0,0,1
DeWitt,203,United States Senator,,Democratic Party,Michael Cooper,2,4,0,6
DeWitt,203,United States Senator,,Democratic Party,Chris Bell,3,1,0,4
DeWitt,203,United States Senator,,Democratic Party,Cristina Tzintzun Ramirez,0,0,1,1
DeWitt,203,United States Senator,,Democratic Party,Sema Hernandez,0,0,0,0
DeWitt,203,United States Senator,,Democratic Party,Jack Daniel Foster Jr,0,0,0,0
DeWitt,203,United States Senator,,Democratic Party,"Mary ""MJ"" Hegar",3,3,3,9
DeWitt,203,Ballots Cast,,Democratic Party,,16,9,8,33
DeWitt,203,United States Senator,,Democratic Party,Undervotes,2,0,0,2
DeWitt,203,United States Senator,,Democratic Party,Overvotes,0,0,0,0
DeWitt,203,"United States Representative, District No. 34",,Democratic Party,Diego Zavala,5,1,1,7
DeWitt,203,"United States Representative, District No. 34",,Democratic Party,Osbert Haro,3,3,1,7
DeWitt,203,"United States Representative, District No. 34",,Democratic Party,Filemon B. Vela,9,5,5,19
DeWitt,203,Ballots Cast,,Democratic Party,,17,9,7,33
DeWitt,203,"United States Representative, District No. 34",,Democratic Party,Undervotes,1,0,1,2
DeWitt,203,"United States Representative, District No. 34",,Democratic Party,Overvotes,0,0,0,0
DeWitt,203,Railroad Commissioner,,Democratic Party,Chrysta Casta√±eda,3,1,4,8
DeWitt,203,Railroad Commissioner,,Democratic Party,Kelly Stone,4,2,2,8
DeWitt,203,Railroad Commissioner,,Democratic Party,Mark Watson,6,4,2,12
DeWitt,203,Railroad Commissioner,,Democratic Party,"Roberto R. ""Beto"" Alonzo",4,2,0,6
DeWitt,203,Ballots Cast,,Democratic Party,,17,9,8,34
DeWitt,203,Railroad Commissioner,,Democratic Party,Undervotes,1,0,0,1
DeWitt,203,Railroad Commissioner,,Democratic Party,Overvotes,0,0,0,0
DeWitt,203,"Chief Justice, Supreme Court",,Democratic Party,Jerry Zimmerer,2,3,1,6
DeWitt,203,"Chief Justice, Supreme Court",,Democratic Party,Amy Clark Meachum,15,6,7,28
DeWitt,203,Ballots Cast,,Democratic Party,,17,9,8,34
DeWitt,203,"Chief Justice, Supreme Court",,Democratic Party,Undervotes,1,0,0,1
DeWitt,203,"Chief Justice, Supreme Court",,Democratic Party,Overvotes,0,0,0,0
DeWitt,203,"Justice, Supreme Court, Place 6 Unexpired Term",,Democratic Party,Larry Praeger,7,7,2,16
DeWitt,203,"Justice, Supreme Court, Place 6 Unexpired Term",,Democratic Party,Kathy Cheng,10,2,6,18
DeWitt,203,Ballots Cast,,Democratic Party,,17,9,8,34
DeWitt,203,"Justice, Supreme Court, Place 6 Unexpired Term",,Democratic Party,Undervotes,1,0,0,1
DeWitt,203,"Justice, Supreme Court, Place 6 Unexpired Term",,Democratic Party,Overvotes,0,0,0,0
DeWitt,203,"Justice, Supreme Court, Place 7",,Democratic Party,Staci Williams,12,7,6,25
DeWitt,203,"Justice, Supreme Court, Place 7",,Democratic Party,Brandy Voss,4,2,2,8
DeWitt,203,Ballots Cast,,Democratic Party,,16,9,8,33
DeWitt,203,"Justice, Supreme Court, Place 7",,Democratic Party,Undervotes,2,0,0,2
DeWitt,203,"Justice, Supreme Court, Place 7",,Democratic Party,Overvotes,0,0,0,0
DeWitt,203,"Justice, Supreme Court, Place 8",,Democratic Party,Peter Kelly,5,5,2,12
DeWitt,203,"Justice, Supreme Court, Place 8",,Democratic Party,Gisela D. Triana,11,4,6,21
DeWitt,203,Ballots Cast,,Democratic Party,,16,9,8,33
DeWitt,203,"Justice, Supreme Court, Place 8",,Democratic Party,Undervotes,2,0,0,2
DeWitt,203,"Justice, Supreme Court, Place 8",,Democratic Party,Overvotes,0,0,0,0
DeWitt,203,"Judge, Court of Criminal Appeals, Place 3",,Democratic Party,Dan Wood,4,4,2,10
DeWitt,203,"Judge, Court of Criminal Appeals, Place 3",,Democratic Party,William Pieratt Demond,0,2,0,2
DeWitt,203,"Judge, Court of Criminal Appeals, Place 3",,Democratic Party,Elizabeth Davis Frizell,10,3,5,18
DeWitt,203,Ballots Cast,,Democratic Party,,14,9,7,30
DeWitt,203,"Judge, Court of Criminal Appeals, Place 3",,Democratic Party,Undervotes,4,0,1,5
DeWitt,203,"Judge, Court of Criminal Appeals, Place 3",,Democratic Party,Overvotes,0,0,0,0
DeWitt,203,"Judge, Court of Criminal Appeals, Place 4",,Democratic Party,Steven Miears,4,6,2,12
DeWitt,203,"Judge, Court of Criminal Appeals, Place 4",,Democratic Party,Tina Clinton,10,3,4,17
DeWitt,203,Ballots Cast,,Democratic Party,,14,9,6,29
DeWitt,203,"Judge, Court of Criminal Appeals, Place 4",,Democratic Party,Undervotes,4,0,2,6
DeWitt,203,"Judge, Court of Criminal Appeals, Place 4",,Democratic Party,Overvotes,0,0,0,0
DeWitt,203,"Judge, Court of Criminal Appeals, Place 9",,Democratic Party,Brandon Birmingham,13,8,7,28
DeWitt,203,Ballots Cast,,Democratic Party,,13,8,7,28
DeWitt,203,"Judge, Court of Criminal Appeals, Place 9",,Democratic Party,Undervotes,5,1,1,7
DeWitt,203,"Judge, Court of Criminal Appeals, Place 9",,Democratic Party,Overvotes,0,0,0,0
DeWitt,203,"State Senator, District 18",,Democratic Party,Michael Antalan,13,8,8,29
DeWitt,203,Ballots Cast,,Democratic Party,,13,8,8,29
DeWitt,203,"State Senator, District 18",,Democratic Party,Undervotes,5,1,0,6
DeWitt,203,"State Senator, District 18",,Democratic Party,Overvotes,0,0,0,0
DeWitt,203,County Chairman,,Democratic Party,Jospeh L. Sheppard,12,9,7,28
DeWitt,203,Ballots Cast,,Democratic Party,,12,9,7,28
DeWitt,203,County Chairman,,Democratic Party,Undervotes,6,0,1,7
DeWitt,203,County Chairman,,Democratic Party,Overvotes,0,0,0,0
DeWitt,203,President,,Republican Party,Zoltan G. Istvan,0,0,0,0
DeWitt,203,President,,Republican Party,Donald J. Trump,118,24,61,203
DeWitt,203,President,,Republican Party,Bill Weld,0,0,0,0
DeWitt,203,President,,Republican Party,Joe Walsh,1,0,0,1
DeWitt,203,President,,Republican Party,"Roque ""Rocky"" De La Fuente Guerra",0,0,0,0
DeWitt,203,President,,Republican Party,Matthew John Matern,0,0,0,0
DeWitt,203,President,,Republican Party,Bob Ely,0,0,0,0
DeWitt,203,President,,Republican Party,Uncommitted,1,2,1,4
DeWitt,203,Ballots Cast,,Republican Party,,120,26,62,208
DeWitt,203,President,,Republican Party,Undervotes,1,1,0,2
DeWitt,203,President,,Republican Party,Overvotes,0,0,0,0
DeWitt,203,United States Senator,,Republican Party,Dwayne Stovall,31,4,10,45
DeWitt,203,United States Senator,,Republican Party,Mark Yancey,6,0,3,9
DeWitt,203,United States Senator,,Republican Party,Virgil Bierschwale,1,0,0,1
DeWitt,203,United States Senator,,Republican Party,John Cornyn,65,21,42,128
DeWitt,203,United States Senator,,Republican Party,John Anthony Castro,5,0,0,5
DeWitt,203,Ballots Cast,,Republican Party,,108,25,55,188
DeWitt,203,United States Senator,,Republican Party,Undervotes,13,2,7,22
DeWitt,203,United States Senator,,Republican Party,Overvotes,0,0,0,0
DeWitt,203,"United States Representative, District No. 34",,Republican Party,Rey Gonzalez,48,3,20,71
DeWitt,203,"United States Representative, District No. 34",,Republican Party,Rod Lingsch,46,18,34,98
DeWitt,203,Ballots Cast,,Republican Party,,94,21,54,169
DeWitt,203,"United States Representative, District No. 34",,Republican Party,Undervotes,27,6,8,41
DeWitt,203,"United States Representative, District No. 34",,Republican Party,Overvotes,0,0,0,0
DeWitt,203,Railroad Commissioner,,Republican Party,Ryan Sitton,38,7,20,65
DeWitt,203,Railroad Commissioner,,Republican Party,"James ""Jim"" Wright",60,16,35,111
DeWitt,203,Ballots Cast,,Republican Party,,98,23,55,176
DeWitt,203,Railroad Commissioner,,Republican Party,Undervotes,23,4,7,34
DeWitt,203,Railroad Commissioner,,Republican Party,Overvotes,0,0,0,0
DeWitt,203,"Chief Justice, Supreme Court",,Republican Party,Nathan Hecht,98,18,53,169
DeWitt,203,Ballots Cast,,Republican Party,,98,18,53,169
DeWitt,203,"Chief Justice, Supreme Court",,Republican Party,Undervotes,23,9,9,41
DeWitt,203,"Chief Justice, Supreme Court",,Republican Party,Overvotes,0,0,0,0
DeWitt,203,"Justice, Supreme Court, Place 6 Unexpired Term",,Republican Party,Jane Bland,99,20,53,172
DeWitt,203,Ballots Cast,,Republican Party,,99,20,53,172
DeWitt,203,"Justice, Supreme Court, Place 6 Unexpired Term",,Republican Party,Undervotes,22,7,9,38
DeWitt,203,"Justice, Supreme Court, Place 6 Unexpired Term",,Republican Party,Overvotes,0,0,0,0
DeWitt,203,"Justice, Supreme Court, Place 7",,Republican Party,Jeff Boyd,99,20,52,171
DeWitt,203,Ballots Cast,,Republican Party,,99,20,52,171
DeWitt,203,"Justice, Supreme Court, Place 7",,Republican Party,Undervotes,22,7,10,39
DeWitt,203,"Justice, Supreme Court, Place 7",,Republican Party,Overvotes,0,0,0,0
DeWitt,203,"Justice, Supreme Court, Place 8",,Republican Party,Brett Busby,97,20,53,170
DeWitt,203,Ballots Cast,,Republican Party,,97,20,53,170
DeWitt,203,"Justice, Supreme Court, Place 8",,Republican Party,Undervotes,24,7,9,40
DeWitt,203,"Justice, Supreme Court, Place 8",,Republican Party,Overvotes,0,0,0,0
DeWitt,203,"Judge, Court of Criminal Appeals, Place 3",,Republican Party,Gina Parker,57,14,29,100
DeWitt,203,"Judge, Court of Criminal Appeals, Place 3",,Republican Party,Bert Richardson,37,10,24,71
DeWitt,203,Ballots Cast,,Republican Party,,94,24,53,171
DeWitt,203,"Judge, Court of Criminal Appeals, Place 3",,Republican Party,Undervotes,27,3,9,39
DeWitt,203,"Judge, Court of Criminal Appeals, Place 3",,Republican Party,Overvotes,0,0,0,0
DeWitt,203,"Judge, Court of Criminal Appeals, Place 4",,Republican Party,Kevin Patrick Yeary,93,19,54,166
DeWitt,203,Ballots Cast,,Republican Party,,93,19,54,166
DeWitt,203,"Judge, Court of Criminal Appeals, Place 4",,Republican Party,Undervotes,28,8,8,44
DeWitt,203,"Judge, Court of Criminal Appeals, Place 4",,Republican Party,Overvotes,0,0,0,0
DeWitt,203,"Judge, Court of Criminal Appeals, Place 9",,Republican Party,David Newell,93,20,52,165
DeWitt,203,Ballots Cast,,Republican Party,,93,20,52,165
DeWitt,203,"Judge, Court of Criminal Appeals, Place 9",,Republican Party,Undervotes,28,7,10,45
DeWitt,203,"Judge, Court of Criminal Appeals, Place 9",,Republican Party,Overvotes,0,0,0,0
DeWitt,203,"State Senator, District 18",,Republican Party,Lois W. Kolkhorst,103,19,58,180
DeWitt,203,Ballots Cast,,Republican Party,,103,19,58,180
DeWitt,203,"State Senator, District 18",,Republican Party,Undervotes,18,8,4,30
DeWitt,203,"State Senator, District 18",,Republican Party,Overvotes,0,0,0,0
DeWitt,203,"State Representative, District 30",,Republican Party,Geanie W. Morrison,88,24,54,166
DeWitt,203,"State Representative, District 30",,Republican Party,Vanessa Hicks-Callaway,22,3,4,29
DeWitt,203,Ballots Cast,,Republican Party,,110,27,58,195
DeWitt,203,"State Representative, District 30",,Republican Party,Undervotes,11,0,4,15
DeWitt,203,"State Representative, District 30",,Republican Party,Overvotes,0,0,0,0
DeWitt,203,"District Attorney, 24th Judicial District",,Republican Party,"Robert C. ""Rob"" Lassman",97,18,59,174
DeWitt,203,Ballots Cast,,Republican Party,,97,18,59,174
DeWitt,203,"District Attorney, 24th Judicial District",,Republican Party,Undervotes,24,9,3,36
DeWitt,203,"District Attorney, 24th Judicial District",,Republican Party,Overvotes,0,0,0,0
DeWitt,203,County Attorney,,Republican Party,Jay Condie,99,18,57,174
DeWitt,203,Ballots Cast,,Republican Party,,99,18,57,174
DeWitt,203,County Attorney,,Republican Party,Undervotes,22,9,5,36
DeWitt,203,County Attorney,,Republican Party,Overvotes,0,0,0,0
DeWitt,203,Sheriff,,Republican Party,Carl R. Bowen,101,18,58,177
DeWitt,203,Ballots Cast,,Republican Party,,101,18,58,177
DeWitt,203,Sheriff,,Republican Party,Undervotes,20,9,4,33
DeWitt,203,Sheriff,,Republican Party,Overvotes,0,0,0,0
DeWitt,203,County Tax Assessor-Collector,,Republican Party,Ashley D. Mraz,83,19,47,149
DeWitt,203,County Tax Assessor-Collector,,Republican Party,Guy Dolan,28,5,10,43
DeWitt,203,Ballots Cast,,Republican Party,,111,24,57,192
DeWitt,203,County Tax Assessor-Collector,,Republican Party,Undervotes,10,3,5,18
DeWitt,203,County Tax Assessor-Collector,,Republican Party,Overvotes,0,0,0,0
DeWitt,203,"Constable, Precinct 1",,Republican Party,Kelly J. Phelps,97,18,55,170
DeWitt,203,Ballots Cast,,Republican Party,,97,18,55,170
DeWitt,203,"Constable, Precinct 1",,Republican Party,Undervotes,24,9,7,40
DeWitt,203,"Constable, Precinct 1",,Republican Party,Overvotes,0,0,0,0
DeWitt,203,County Chairman,,Republican Party,Paul Guidry,98,18,53,169
DeWitt,203,Ballots Cast,,Republican Party,,98,18,53,169
DeWitt,203,County Chairman,,Republican Party,Undervotes,23,9,9,41
DeWitt,203,County Chairman,,Republican Party,Overvotes,0,0,0,0
DeWitt,203,Proposition #1,,Democratic Party,Yes,15,7,6,28
DeWitt,203,Proposition #1,,Democratic Party,No,2,1,1,4
DeWitt,203,Ballots Cast,,Democratic Party,,17,8,7,32
DeWitt,203,Proposition #1,,Democratic Party,Undervotes,1,0,1,2
DeWitt,203,Proposition #1,,Democratic Party,Overvotes,0,1,0,1
DeWitt,203,Proposition #2,,Democratic Party,Yes,13,9,6,28
DeWitt,203,Proposition #2,,Democratic Party,No,2,0,1,3
DeWitt,203,Ballots Cast,,Democratic Party,,15,9,7,31
DeWitt,203,Proposition #2,,Democratic Party,Undervotes,3,0,1,4
DeWitt,203,Proposition #2,,Democratic Party,Overvotes,0,0,0,0
DeWitt,203,Proposition #3,,Democratic Party,Yes,14,9,6,29
DeWitt,203,Proposition #3,,Democratic Party,No,1,0,1,2
DeWitt,203,Ballots Cast,,Democratic Party,,15,9,7,31
DeWitt,203,Proposition #3,,Democratic Party,Undervotes,3,0,1,4
DeWitt,203,Proposition #3,,Democratic Party,Overvotes,0,0,0,0
DeWitt,203,Proposition #4,,Democratic Party,Yes,12,8,6,26
DeWitt,203,Proposition #4,,Democratic Party,No,2,0,1,3
DeWitt,203,Ballots Cast,,Democratic Party,,14,8,7,29
DeWitt,203,Proposition #4,,Democratic Party,Undervotes,4,0,1,5
DeWitt,203,Proposition #4,,Democratic Party,Overvotes,0,1,0,1
DeWitt,203,Proposition #5,,Democratic Party,Yes,12,9,6,27
DeWitt,203,Proposition #5,,Democratic Party,No,1,0,1,2
DeWitt,203,Ballots Cast,,Democratic Party,,13,9,7,29
DeWitt,203,Proposition #5,,Democratic Party,Undervotes,5,0,1,6
DeWitt,203,Proposition #5,,Democratic Party,Overvotes,0,0,0,0
DeWitt,203,Proposition #6,,Democratic Party,Yes,14,9,6,29
DeWitt,203,Proposition #6,,Democratic Party,No,1,0,1,2
DeWitt,203,Ballots Cast,,Democratic Party,,15,9,7,31
DeWitt,203,Proposition #6,,Democratic Party,Undervotes,3,0,1,4
DeWitt,203,Proposition #6,,Democratic Party,Overvotes,0,0,0,0
DeWitt,203,Proposition #7,,Democratic Party,Yes,13,9,6,28
DeWitt,203,Proposition #7,,Democratic Party,No,2,0,1,3
DeWitt,203,Ballots Cast,,Democratic Party,,15,9,7,31
DeWitt,203,Proposition #7,,Democratic Party,Undervotes,3,0,1,4
DeWitt,203,Proposition #7,,Democratic Party,Overvotes,0,0,0,0
DeWitt,203,Proposition #8,,Democratic Party,Yes,14,9,7,30
DeWitt,203,Proposition #8,,Democratic Party,No,1,0,0,1
DeWitt,203,Ballots Cast,,Democratic Party,,15,9,7,31
DeWitt,203,Proposition #8,,Democratic Party,Undervotes,3,0,1,4
DeWitt,203,Proposition #8,,Democratic Party,Overvotes,0,0,0,0
DeWitt,203,Proposition #9,,Democratic Party,Yes,14,9,6,29
DeWitt,203,Proposition #9,,Democratic Party,No,1,0,1,2
DeWitt,203,Ballots Cast,,Democratic Party,,15,9,7,31
DeWitt,203,Proposition #9,,Democratic Party,Undervotes,3,0,1,4
DeWitt,203,Proposition #9,,Democratic Party,Overvotes,0,0,0,0
DeWitt,203,Proposition #10,,Democratic Party,Yes,13,8,7,28
DeWitt,203,Proposition #10,,Democratic Party,No,2,0,0,2
DeWitt,203,Ballots Cast,,Democratic Party,,15,8,7,30
DeWitt,203,Proposition #10,,Democratic Party,Undervotes,3,0,1,4
DeWitt,203,Proposition #10,,Democratic Party,Overvotes,0,1,0,1
DeWitt,203,Proposition #11,,Democratic Party,Yes,13,7,6,26
DeWitt,203,Proposition #11,,Democratic Party,No,2,2,1,5
DeWitt,203,Ballots Cast,,Democratic Party,,15,9,7,31
DeWitt,203,Proposition #11,,Democratic Party,Undervotes,3,0,1,4
DeWitt,203,Proposition #11,,Democratic Party,Overvotes,0,0,0,0
DeWitt,203,Proposition 1,,Republican Party,Yes,106,25,54,185
DeWitt,203,Proposition 1,,Republican Party,No,12,2,7,21
DeWitt,203,Ballots Cast,,Republican Party,,118,27,61,206
DeWitt,203,Proposition 1,,Republican Party,Undervotes,3,0,1,4
DeWitt,203,Proposition 1,,Republican Party,Overvotes,0,0,0,0
DeWitt,203,Proposition 2,,Republican Party,Yes,107,23,54,184
DeWitt,203,Proposition 2,,Republican Party,No,13,3,8,24
DeWitt,203,Ballots Cast,,Republican Party,,120,26,62,208
DeWitt,203,Proposition 2,,Republican Party,Undervotes,1,1,0,2
DeWitt,203,Proposition 2,,Republican Party,Overvotes,0,0,0,0
DeWitt,203,Proposition 3,,Republican Party,Yes,107,27,55,189
DeWitt,203,Proposition 3,,Republican Party,No,8,0,2,10
DeWitt,203,Ballots Cast,,Republican Party,,115,27,57,199
DeWitt,203,Proposition 3,,Republican Party,Undervotes,6,0,5,11
DeWitt,203,Proposition 3,,Republican Party,Overvotes,0,0,0,0
DeWitt,203,Proposition 4,,Republican Party,Yes,113,26,55,194
DeWitt,203,Proposition 4,,Republican Party,No,3,0,2,5
DeWitt,203,Ballots Cast,,Republican Party,,116,26,57,199
DeWitt,203,Proposition 4,,Republican Party,Undervotes,5,1,5,11
DeWitt,203,Proposition 4,,Republican Party,Overvotes,0,0,0,0
DeWitt,203,Proposition 5,,Republican Party,Yes,111,23,57,191
DeWitt,203,Proposition 5,,Republican Party,No,7,2,4,13
DeWitt,203,Ballots Cast,,Republican Party,,118,25,61,204
DeWitt,203,Proposition 5,,Republican Party,Undervotes,3,2,1,6
DeWitt,203,Proposition 5,,Republican Party,Overvotes,0,0,0,0
DeWitt,203,Proposition 6,,Republican Party,Yes,112,26,54,192
DeWitt,203,Proposition 6,,Republican Party,No,4,1,3,8
DeWitt,203,Ballots Cast,,Republican Party,,116,27,57,200
DeWitt,203,Proposition 6,,Republican Party,Undervotes,5,0,5,10
DeWitt,203,Proposition 6,,Republican Party,Overvotes,0,0,0,0
DeWitt,203,Proposition 7,,Republican Party,Yes,110,26,60,196
DeWitt,203,Proposition 7,,Republican Party,No,3,0,0,3
DeWitt,203,Ballots Cast,,Republican Party,,113,26,60,199
DeWitt,203,Proposition 7,,Republican Party,Undervotes,8,1,2,11
DeWitt,203,Proposition 7,,Republican Party,Overvotes,0,0,0,0
DeWitt,203,Proposition 8,,Republican Party,Yes,116,27,60,203
DeWitt,203,Proposition 8,,Republican Party,No,1,0,1,2
DeWitt,203,Ballots Cast,,Republican Party,,117,27,61,205
DeWitt,203,Proposition 8,,Republican Party,Undervotes,4,0,1,5
DeWitt,203,Proposition 8,,Republican Party,Overvotes,0,0,0,0
DeWitt,203,Proposition 9,,Republican Party,Yes,114,27,54,195
DeWitt,203,Proposition 9,,Republican Party,No,5,0,2,7
DeWitt,203,Ballots Cast,,Republican Party,,119,27,56,202
DeWitt,203,Proposition 9,,Republican Party,Undervotes,2,0,6,8
DeWitt,203,Proposition 9,,Republican Party,Overvotes,0,0,0,0
DeWitt,203,Proposition 10,,Republican Party,Yes,102,19,49,170
DeWitt,203,Proposition 10,,Republican Party,No,7,6,7,20
DeWitt,203,Ballots Cast,,Republican Party,,109,25,56,190
DeWitt,203,Proposition 10,,Republican Party,Undervotes,12,2,6,20
DeWitt,203,Proposition 10,,Republican Party,Overvotes,0,0,0,0
DeWitt,301,President,,Democratic Party,Amy Klobuchar,0,1,1,2
DeWitt,301,President,,Democratic Party,Joseph R. Biden,11,6,4,21
DeWitt,301,President,,Democratic Party,Michael Bennet,0,0,0,0
DeWitt,301,President,,Democratic Party,Marianne Williamson,0,0,0,0
DeWitt,301,President,,Democratic Party,Michael R. Bloomberg,3,4,2,9
DeWitt,301,President,,Democratic Party,Elizabeth Warren,2,0,0,2
DeWitt,301,President,,Democratic Party,Andrew Yang,0,0,0,0
DeWitt,301,President,,Democratic Party,Tom Steyer,0,0,0,0
DeWitt,301,President,,Democratic Party,Pete Buttigieg,0,2,0,2
DeWitt,301,President,,Democratic Party,Tulsi Gabbard,0,0,0,0
DeWitt,301,President,,Democratic Party,Robby Wells,0,0,0,0
DeWitt,301,President,,Democratic Party,Deval Patrick,0,0,0,0
DeWitt,301,President,,Democratic Party,Bernie Sanders,6,2,3,11
DeWitt,301,President,,Democratic Party,"Roque ""Rocky"" De La Fuente Guerra",0,0,0,0
DeWitt,301,President,,Democratic Party,John K. Delaney,0,0,0,0
DeWitt,301,President,,Democratic Party,Cory Booker,0,0,0,0
DeWitt,301,President,,Democratic Party,Juli√°n Castro,0,1,0,1
DeWitt,301,Ballots Cast,,Democratic Party,,22,16,10,48
DeWitt,301,President,,Democratic Party,Undervotes,0,0,0,0
DeWitt,301,President,,Democratic Party,Overvotes,0,0,0,0
DeWitt,301,United States Senator,,Democratic Party,Victor Hugo Harris,2,0,0,2
DeWitt,301,United States Senator,,Democratic Party,"Annie ""Mam√°"" Garcia",3,1,0,4
DeWitt,301,United States Senator,,Democratic Party,Amanda K. Edwards,2,2,1,5
DeWitt,301,United States Senator,,Democratic Party,Royce West,2,1,0,3
DeWitt,301,United States Senator,,Democratic Party,Adrian Ocegueda,1,1,1,3
DeWitt,301,United States Senator,,Democratic Party,D.R. Hunter,1,0,0,1
DeWitt,301,United States Senator,,Democratic Party,Michael Cooper,0,1,0,1
DeWitt,301,United States Senator,,Democratic Party,Chris Bell,2,0,2,4
DeWitt,301,United States Senator,,Democratic Party,Cristina Tzintzun Ramirez,1,3,2,6
DeWitt,301,United States Senator,,Democratic Party,Sema Hernandez,1,1,0,2
DeWitt,301,United States Senator,,Democratic Party,Jack Daniel Foster Jr,0,1,0,1
DeWitt,301,United States Senator,,Democratic Party,"Mary ""MJ"" Hegar",5,3,4,12
DeWitt,301,Ballots Cast,,Democratic Party,,20,14,10,44
DeWitt,301,United States Senator,,Democratic Party,Undervotes,2,2,0,4
DeWitt,301,United States Senator,,Democratic Party,Overvotes,0,0,0,0
DeWitt,301,"United States Representative, District No. 34",,Democratic Party,Diego Zavala,7,2,1,10
DeWitt,301,"United States Representative, District No. 34",,Democratic Party,Osbert Haro,3,2,1,6
DeWitt,301,"United States Representative, District No. 34",,Democratic Party,Filemon B. Vela,11,10,8,29
DeWitt,301,Ballots Cast,,Democratic Party,,21,14,10,45
DeWitt,301,"United States Representative, District No. 34",,Democratic Party,Undervotes,1,2,0,3
DeWitt,301,"United States Representative, District No. 34",,Democratic Party,Overvotes,0,0,0,0
DeWitt,301,Railroad Commissioner,,Democratic Party,Chrysta Casta√±eda,5,4,1,10
DeWitt,301,Railroad Commissioner,,Democratic Party,Kelly Stone,5,2,3,10
DeWitt,301,Railroad Commissioner,,Democratic Party,Mark Watson,8,4,3,15
DeWitt,301,Railroad Commissioner,,Democratic Party,"Roberto R. ""Beto"" Alonzo",3,2,3,8
DeWitt,301,Ballots Cast,,Democratic Party,,21,12,10,43
DeWitt,301,Railroad Commissioner,,Democratic Party,Undervotes,1,4,0,5
DeWitt,301,Railroad Commissioner,,Democratic Party,Overvotes,0,0,0,0
DeWitt,301,"Chief Justice, Supreme Court",,Democratic Party,Jerry Zimmerer,4,3,2,9
DeWitt,301,"Chief Justice, Supreme Court",,Democratic Party,Amy Clark Meachum,16,9,8,33
DeWitt,301,Ballots Cast,,Democratic Party,,20,12,10,42
DeWitt,301,"Chief Justice, Supreme Court",,Democratic Party,Undervotes,2,4,0,6
DeWitt,301,"Chief Justice, Supreme Court",,Democratic Party,Overvotes,0,0,0,0
DeWitt,301,"Justice, Supreme Court, Place 6 Unexpired Term",,Democratic Party,Larry Praeger,8,2,1,11
DeWitt,301,"Justice, Supreme Court, Place 6 Unexpired Term",,Democratic Party,Kathy Cheng,13,9,9,31
DeWitt,301,Ballots Cast,,Democratic Party,,21,11,10,42
DeWitt,301,"Justice, Supreme Court, Place 6 Unexpired Term",,Democratic Party,Undervotes,1,5,0,6
DeWitt,301,"Justice, Supreme Court, Place 6 Unexpired Term",,Democratic Party,Overvotes,0,0,0,0
DeWitt,301,"Justice, Supreme Court, Place 7",,Democratic Party,Staci Williams,14,5,7,26
DeWitt,301,"Justice, Supreme Court, Place 7",,Democratic Party,Brandy Voss,8,7,3,18
DeWitt,301,Ballots Cast,,Democratic Party,,22,12,10,44
DeWitt,301,"Justice, Supreme Court, Place 7",,Democratic Party,Undervotes,0,4,0,4
DeWitt,301,"Justice, Supreme Court, Place 7",,Democratic Party,Overvotes,0,0,0,0
DeWitt,301,"Justice, Supreme Court, Place 8",,Democratic Party,Peter Kelly,9,4,5,18
DeWitt,301,"Justice, Supreme Court, Place 8",,Democratic Party,Gisela D. Triana,12,8,4,24
DeWitt,301,Ballots Cast,,Democratic Party,,21,12,9,42
DeWitt,301,"Justice, Supreme Court, Place 8",,Democratic Party,Undervotes,1,4,1,6
DeWitt,301,"Justice, Supreme Court, Place 8",,Democratic Party,Overvotes,0,0,0,0
DeWitt,301,"Judge, Court of Criminal Appeals, Place 3",,Democratic Party,Dan Wood,7,1,1,9
DeWitt,301,"Judge, Court of Criminal Appeals, Place 3",,Democratic Party,William Pieratt Demond,1,0,0,1
DeWitt,301,"Judge, Court of Criminal Appeals, Place 3",,Democratic Party,Elizabeth Davis Frizell,14,11,8,33
DeWitt,301,Ballots Cast,,Democratic Party,,22,12,9,43
DeWitt,301,"Judge, Court of Criminal Appeals, Place 3",,Democratic Party,Undervotes,0,4,1,5
DeWitt,301,"Judge, Court of Criminal Appeals, Place 3",,Democratic Party,Overvotes,0,0,0,0
DeWitt,301,"Judge, Court of Criminal Appeals, Place 4",,Democratic Party,Steven Miears,4,1,1,6
DeWitt,301,"Judge, Court of Criminal Appeals, Place 4",,Democratic Party,Tina Clinton,17,11,9,37
DeWitt,301,Ballots Cast,,Democratic Party,,21,12,10,43
DeWitt,301,"Judge, Court of Criminal Appeals, Place 4",,Democratic Party,Undervotes,1,4,0,5
DeWitt,301,"Judge, Court of Criminal Appeals, Place 4",,Democratic Party,Overvotes,0,0,0,0
DeWitt,301,"Judge, Court of Criminal Appeals, Place 9",,Democratic Party,Brandon Birmingham,20,10,9,39
DeWitt,301,Ballots Cast,,Democratic Party,,20,10,9,39
DeWitt,301,"Judge, Court of Criminal Appeals, Place 9",,Democratic Party,Undervotes,2,6,1,9
DeWitt,301,"Judge, Court of Criminal Appeals, Place 9",,Democratic Party,Overvotes,0,0,0,0
DeWitt,301,"State Senator, District 18",,Democratic Party,Michael Antalan,19,10,9,38
DeWitt,301,Ballots Cast,,Democratic Party,,19,10,9,38
DeWitt,301,"State Senator, District 18",,Democratic Party,Undervotes,3,6,1,10
DeWitt,301,"State Senator, District 18",,Democratic Party,Overvotes,0,0,0,0
DeWitt,301,County Chairman,,Democratic Party,Jospeh L. Sheppard,20,11,9,40
DeWitt,301,Ballots Cast,,Democratic Party,,20,11,9,40
DeWitt,301,County Chairman,,Democratic Party,Undervotes,2,5,1,8
DeWitt,301,County Chairman,,Democratic Party,Overvotes,0,0,0,0
DeWitt,301,President,,Republican Party,Zoltan G. Istvan,0,0,0,0
DeWitt,301,President,,Republican Party,Donald J. Trump,215,57,62,334
DeWitt,301,President,,Republican Party,Bill Weld,0,0,0,0
DeWitt,301,President,,Republican Party,Joe Walsh,1,0,0,1
DeWitt,301,President,,Republican Party,"Roque ""Rocky"" De La Fuente Guerra",0,0,0,0
DeWitt,301,President,,Republican Party,Matthew John Matern,0,1,0,1
DeWitt,301,President,,Republican Party,Bob Ely,0,0,0,0
DeWitt,301,President,,Republican Party,Uncommitted,4,3,0,7
DeWitt,301,Ballots Cast,,Republican Party,,220,61,62,343
DeWitt,301,President,,Republican Party,Undervotes,2,0,1,3
DeWitt,301,President,,Republican Party,Overvotes,0,1,0,1
DeWitt,301,United States Senator,,Republican Party,Dwayne Stovall,27,3,14,44
DeWitt,301,United States Senator,,Republican Party,Mark Yancey,15,1,2,18
DeWitt,301,United States Senator,,Republican Party,Virgil Bierschwale,1,0,1,2
DeWitt,301,United States Senator,,Republican Party,John Cornyn,155,55,42,252
DeWitt,301,United States Senator,,Republican Party,John Anthony Castro,9,0,1,10
DeWitt,301,Ballots Cast,,Republican Party,,207,59,60,326
DeWitt,301,United States Senator,,Republican Party,Undervotes,15,2,3,20
DeWitt,301,United States Senator,,Republican Party,Overvotes,0,1,0,1
DeWitt,301,"United States Representative, District No. 34",,Republican Party,Rey Gonzalez,111,25,28,164
DeWitt,301,"United States Representative, District No. 34",,Republican Party,Rod Lingsch,84,25,30,139
DeWitt,301,Ballots Cast,,Republican Party,,195,50,58,303
DeWitt,301,"United States Representative, District No. 34",,Republican Party,Undervotes,27,12,5,44
DeWitt,301,"United States Representative, District No. 34",,Republican Party,Overvotes,0,0,0,0
DeWitt,301,Railroad Commissioner,,Republican Party,Ryan Sitton,85,27,26,138
DeWitt,301,Railroad Commissioner,,Republican Party,"James ""Jim"" Wright",114,27,29,170
DeWitt,301,Ballots Cast,,Republican Party,,199,54,55,308
DeWitt,301,Railroad Commissioner,,Republican Party,Undervotes,23,8,8,39
DeWitt,301,Railroad Commissioner,,Republican Party,Overvotes,0,0,0,0
DeWitt,301,"Chief Justice, Supreme Court",,Republican Party,Nathan Hecht,192,46,53,291
DeWitt,301,Ballots Cast,,Republican Party,,192,46,53,291
DeWitt,301,"Chief Justice, Supreme Court",,Republican Party,Undervotes,30,16,10,56
DeWitt,301,"Chief Justice, Supreme Court",,Republican Party,Overvotes,0,0,0,0
DeWitt,301,"Justice, Supreme Court, Place 6 Unexpired Term",,Republican Party,Jane Bland,190,44,52,286
DeWitt,301,Ballots Cast,,Republican Party,,190,44,52,286
DeWitt,301,"Justice, Supreme Court, Place 6 Unexpired Term",,Republican Party,Undervotes,32,18,11,61
DeWitt,301,"Justice, Supreme Court, Place 6 Unexpired Term",,Republican Party,Overvotes,0,0,0,0
DeWitt,301,"Justice, Supreme Court, Place 7",,Republican Party,Jeff Boyd,189,44,53,286
DeWitt,301,Ballots Cast,,Republican Party,,189,44,53,286
DeWitt,301,"Justice, Supreme Court, Place 7",,Republican Party,Undervotes,33,18,10,61
DeWitt,301,"Justice, Supreme Court, Place 7",,Republican Party,Overvotes,0,0,0,0
DeWitt,301,"Justice, Supreme Court, Place 8",,Republican Party,Brett Busby,193,44,54,291
DeWitt,301,Ballots Cast,,Republican Party,,193,44,54,291
DeWitt,301,"Justice, Supreme Court, Place 8",,Republican Party,Undervotes,29,18,9,56
DeWitt,301,"Justice, Supreme Court, Place 8",,Republican Party,Overvotes,0,0,0,0
DeWitt,301,"Judge, Court of Criminal Appeals, Place 3",,Republican Party,Gina Parker,105,19,28,152
DeWitt,301,"Judge, Court of Criminal Appeals, Place 3",,Republican Party,Bert Richardson,90,25,29,144
DeWitt,301,Ballots Cast,,Republican Party,,195,44,57,296
DeWitt,301,"Judge, Court of Criminal Appeals, Place 3",,Republican Party,Undervotes,27,18,6,51
DeWitt,301,"Judge, Court of Criminal Appeals, Place 3",,Republican Party,Overvotes,0,0,0,0
DeWitt,301,"Judge, Court of Criminal Appeals, Place 4",,Republican Party,Kevin Patrick Yeary,194,45,57,296
DeWitt,301,Ballots Cast,,Republican Party,,194,45,57,296
DeWitt,301,"Judge, Court of Criminal Appeals, Place 4",,Republican Party,Undervotes,28,17,6,51
DeWitt,301,"Judge, Court of Criminal Appeals, Place 4",,Republican Party,Overvotes,0,0,0,0
DeWitt,301,"Judge, Court of Criminal Appeals, Place 9",,Republican Party,David Newell,191,45,53,289
DeWitt,301,Ballots Cast,,Republican Party,,191,45,53,289
DeWitt,301,"Judge, Court of Criminal Appeals, Place 9",,Republican Party,Undervotes,31,17,10,58
DeWitt,301,"Judge, Court of Criminal Appeals, Place 9",,Republican Party,Overvotes,0,0,0,0
DeWitt,301,"State Senator, District 18",,Republican Party,Lois W. Kolkhorst,194,48,56,298
DeWitt,301,Ballots Cast,,Republican Party,,194,48,56,298
DeWitt,301,"State Senator, District 18",,Republican Party,Undervotes,28,14,7,49
DeWitt,301,"State Senator, District 18",,Republican Party,Overvotes,0,0,0,0
DeWitt,301,"State Representative, District 30",,Republican Party,Geanie W. Morrison,174,58,48,280
DeWitt,301,"State Representative, District 30",,Republican Party,Vanessa Hicks-Callaway,40,2,13,55
DeWitt,301,Ballots Cast,,Republican Party,,214,60,61,335
DeWitt,301,"State Representative, District 30",,Republican Party,Undervotes,8,2,2,12
DeWitt,301,"State Representative, District 30",,Republican Party,Overvotes,0,0,0,0
DeWitt,301,"District Attorney, 24th Judicial District",,Republican Party,"Robert C. ""Rob"" Lassman",194,48,57,299
DeWitt,301,Ballots Cast,,Republican Party,,194,48,57,299
DeWitt,301,"District Attorney, 24th Judicial District",,Republican Party,Undervotes,28,14,6,48
DeWitt,301,"District Attorney, 24th Judicial District",,Republican Party,Overvotes,0,0,0,0
DeWitt,301,County Attorney,,Republican Party,Jay Condie,193,47,57,297
DeWitt,301,Ballots Cast,,Republican Party,,193,47,57,297
DeWitt,301,County Attorney,,Republican Party,Undervotes,29,15,6,50
DeWitt,301,County Attorney,,Republican Party,Overvotes,0,0,0,0
DeWitt,301,Sheriff,,Republican Party,Carl R. Bowen,195,53,59,307
DeWitt,301,Ballots Cast,,Republican Party,,195,53,59,307
DeWitt,301,Sheriff,,Republican Party,Undervotes,27,9,4,40
DeWitt,301,Sheriff,,Republican Party,Overvotes,0,0,0,0
DeWitt,301,County Tax Assessor-Collector,,Republican Party,Ashley D. Mraz,162,47,48,257
DeWitt,301,County Tax Assessor-Collector,,Republican Party,Guy Dolan,52,8,15,75
DeWitt,301,Ballots Cast,,Republican Party,,214,55,63,332
DeWitt,301,County Tax Assessor-Collector,,Republican Party,Undervotes,8,6,0,14
DeWitt,301,County Tax Assessor-Collector,,Republican Party,Overvotes,0,1,0,1
DeWitt,301,"County Commissioner, Precinct 3",,Republican Party,James Kaiser,202,51,57,310
DeWitt,301,Ballots Cast,,Republican Party,,202,51,57,310
DeWitt,301,"County Commissioner, Precinct 3",,Republican Party,Undervotes,20,11,6,37
DeWitt,301,"County Commissioner, Precinct 3",,Republican Party,Overvotes,0,0,0,0
DeWitt,301,"Constable, Precinct 2",,Republican Party,Jefferson Hobbs,116,32,37,185
DeWitt,301,"Constable, Precinct 2",,Republican Party,Jeff Abbott,95,21,26,142
DeWitt,301,Ballots Cast,,Republican Party,,211,53,63,327
DeWitt,301,"Constable, Precinct 2",,Republican Party,Undervotes,11,9,0,20
DeWitt,301,"Constable, Precinct 2",,Republican Party,Overvotes,0,0,0,0
DeWitt,301,County Chairman,,Republican Party,Paul Guidry,188,48,54,290
DeWitt,301,Ballots Cast,,Republican Party,,188,48,54,290
DeWitt,301,County Chairman,,Republican Party,Undervotes,34,14,9,57
DeWitt,301,County Chairman,,Republican Party,Overvotes,0,0,0,0
DeWitt,301,Proposition #1,,Democratic Party,Yes,17,14,10,41
DeWitt,301,Proposition #1,,Democratic Party,No,2,0,0,2
DeWitt,301,Ballots Cast,,Democratic Party,,19,14,10,43
DeWitt,301,Proposition #1,,Democratic Party,Undervotes,3,2,0,5
DeWitt,301,Proposition #1,,Democratic Party,Overvotes,0,0,0,0
DeWitt,301,Proposition #2,,Democratic Party,Yes,19,13,10,42
DeWitt,301,Proposition #2,,Democratic Party,No,2,2,0,4
DeWitt,301,Ballots Cast,,Democratic Party,,21,15,10,46
DeWitt,301,Proposition #2,,Democratic Party,Undervotes,1,1,0,2
DeWitt,301,Proposition #2,,Democratic Party,Overvotes,0,0,0,0
DeWitt,301,Proposition #3,,Democratic Party,Yes,21,14,10,45
DeWitt,301,Proposition #3,,Democratic Party,No,1,0,0,1
DeWitt,301,Ballots Cast,,Democratic Party,,22,14,10,46
DeWitt,301,Proposition #3,,Democratic Party,Undervotes,0,2,0,2
DeWitt,301,Proposition #3,,Democratic Party,Overvotes,0,0,0,0
DeWitt,301,Proposition #4,,Democratic Party,Yes,20,14,10,44
DeWitt,301,Proposition #4,,Democratic Party,No,1,0,0,1
DeWitt,301,Ballots Cast,,Democratic Party,,21,14,10,45
DeWitt,301,Proposition #4,,Democratic Party,Undervotes,1,2,0,3
DeWitt,301,Proposition #4,,Democratic Party,Overvotes,0,0,0,0
DeWitt,301,Proposition #5,,Democratic Party,Yes,20,14,10,44
DeWitt,301,Proposition #5,,Democratic Party,No,1,0,0,1
DeWitt,301,Ballots Cast,,Democratic Party,,21,14,10,45
DeWitt,301,Proposition #5,,Democratic Party,Undervotes,1,2,0,3
DeWitt,301,Proposition #5,,Democratic Party,Overvotes,0,0,0,0
DeWitt,301,Proposition #6,,Democratic Party,Yes,21,14,10,45
DeWitt,301,Proposition #6,,Democratic Party,No,1,0,0,1
DeWitt,301,Ballots Cast,,Democratic Party,,22,14,10,46
DeWitt,301,Proposition #6,,Democratic Party,Undervotes,0,2,0,2
DeWitt,301,Proposition #6,,Democratic Party,Overvotes,0,0,0,0
DeWitt,301,Proposition #7,,Democratic Party,Yes,20,14,10,44
DeWitt,301,Proposition #7,,Democratic Party,No,1,1,0,2
DeWitt,301,Ballots Cast,,Democratic Party,,21,15,10,46
DeWitt,301,Proposition #7,,Democratic Party,Undervotes,1,1,0,2
DeWitt,301,Proposition #7,,Democratic Party,Overvotes,0,0,0,0
DeWitt,301,Proposition #8,,Democratic Party,Yes,20,14,10,44
DeWitt,301,Proposition #8,,Democratic Party,No,1,0,0,1
DeWitt,301,Ballots Cast,,Democratic Party,,21,14,10,45
DeWitt,301,Proposition #8,,Democratic Party,Undervotes,1,2,0,3
DeWitt,301,Proposition #8,,Democratic Party,Overvotes,0,0,0,0
DeWitt,301,Proposition #9,,Democratic Party,Yes,19,14,10,43
DeWitt,301,Proposition #9,,Democratic Party,No,1,0,0,1
DeWitt,301,Ballots Cast,,Democratic Party,,20,14,10,44
DeWitt,301,Proposition #9,,Democratic Party,Undervotes,2,2,0,4
DeWitt,301,Proposition #9,,Democratic Party,Overvotes,0,0,0,0
DeWitt,301,Proposition #10,,Democratic Party,Yes,19,14,10,43
DeWitt,301,Proposition #10,,Democratic Party,No,1,0,0,1
DeWitt,301,Ballots Cast,,Democratic Party,,20,14,10,44
DeWitt,301,Proposition #10,,Democratic Party,Undervotes,2,2,0,4
DeWitt,301,Proposition #10,,Democratic Party,Overvotes,0,0,0,0
DeWitt,301,Proposition #11,,Democratic Party,Yes,20,14,9,43
DeWitt,301,Proposition #11,,Democratic Party,No,1,0,1,2
DeWitt,301,Ballots Cast,,Democratic Party,,21,14,10,45
DeWitt,301,Proposition #11,,Democratic Party,Undervotes,1,2,0,3
DeWitt,301,Proposition #11,,Democratic Party,Overvotes,0,0,0,0
DeWitt,301,Proposition 1,,Republican Party,Yes,193,57,52,302
DeWitt,301,Proposition 1,,Republican Party,No,23,4,9,36
DeWitt,301,Ballots Cast,,Republican Party,,216,61,61,338
DeWitt,301,Proposition 1,,Republican Party,Undervotes,6,1,2,9
DeWitt,301,Proposition 1,,Republican Party,Overvotes,0,0,0,0
DeWitt,301,Proposition 2,,Republican Party,Yes,192,53,49,294
DeWitt,301,Proposition 2,,Republican Party,No,25,8,12,45
DeWitt,301,Ballots Cast,,Republican Party,,217,61,61,339
DeWitt,301,Proposition 2,,Republican Party,Undervotes,5,1,2,8
DeWitt,301,Proposition 2,,Republican Party,Overvotes,0,0,0,0
DeWitt,301,Proposition 3,,Republican Party,Yes,197,55,53,305
DeWitt,301,Proposition 3,,Republican Party,No,13,5,8,26
DeWitt,301,Ballots Cast,,Republican Party,,210,60,61,331
DeWitt,301,Proposition 3,,Republican Party,Undervotes,12,2,2,16
DeWitt,301,Proposition 3,,Republican Party,Overvotes,0,0,0,0
DeWitt,301,Proposition 4,,Republican Party,Yes,204,55,58,317
DeWitt,301,Proposition 4,,Republican Party,No,10,2,3,15
DeWitt,301,Ballots Cast,,Republican Party,,214,57,61,332
DeWitt,301,Proposition 4,,Republican Party,Undervotes,8,5,2,15
DeWitt,301,Proposition 4,,Republican Party,Overvotes,0,0,0,0
DeWitt,301,Proposition 5,,Republican Party,Yes,189,54,51,294
DeWitt,301,Proposition 5,,Republican Party,No,18,4,8,30
DeWitt,301,Ballots Cast,,Republican Party,,207,58,59,324
DeWitt,301,Proposition 5,,Republican Party,Undervotes,15,4,4,23
DeWitt,301,Proposition 5,,Republican Party,Overvotes,0,0,0,0
DeWitt,301,Proposition 6,,Republican Party,Yes,203,57,53,313
DeWitt,301,Proposition 6,,Republican Party,No,5,2,8,15
DeWitt,301,Ballots Cast,,Republican Party,,208,59,61,328
DeWitt,301,Proposition 6,,Republican Party,Undervotes,14,3,2,19
DeWitt,301,Proposition 6,,Republican Party,Overvotes,0,0,0,0
DeWitt,301,Proposition 7,,Republican Party,Yes,212,56,61,329
DeWitt,301,Proposition 7,,Republican Party,No,3,2,2,7
DeWitt,301,Ballots Cast,,Republican Party,,215,58,63,336
DeWitt,301,Proposition 7,,Republican Party,Undervotes,7,4,0,11
DeWitt,301,Proposition 7,,Republican Party,Overvotes,0,0,0,0
DeWitt,301,Proposition 8,,Republican Party,Yes,211,59,60,330
DeWitt,301,Proposition 8,,Republican Party,No,3,0,1,4
DeWitt,301,Ballots Cast,,Republican Party,,214,59,61,334
DeWitt,301,Proposition 8,,Republican Party,Undervotes,8,3,2,13
DeWitt,301,Proposition 8,,Republican Party,Overvotes,0,0,0,0
DeWitt,301,Proposition 9,,Republican Party,Yes,204,60,59,323
DeWitt,301,Proposition 9,,Republican Party,No,9,1,1,11
DeWitt,301,Ballots Cast,,Republican Party,,213,61,60,334
DeWitt,301,Proposition 9,,Republican Party,Undervotes,9,1,3,13
DeWitt,301,Proposition 9,,Republican Party,Overvotes,0,0,0,0
DeWitt,301,Proposition 10,,Republican Party,Yes,193,50,56,299
DeWitt,301,Proposition 10,,Republican Party,No,19,8,4,31
DeWitt,301,Ballots Cast,,Republican Party,,212,58,60,330
DeWitt,301,Proposition 10,,Republican Party,Undervotes,10,4,3,17
DeWitt,301,Proposition 10,,Republican Party,Overvotes,0,0,0,0
DeWitt,302,President,,Democratic Party,Amy Klobuchar,1,0,0,1
DeWitt,302,President,,Democratic Party,Joseph R. Biden,13,6,1,20
DeWitt,302,President,,Democratic Party,Michael Bennet,1,0,0,1
DeWitt,302,President,,Democratic Party,Marianne Williamson,0,0,0,0
DeWitt,302,President,,Democratic Party,Michael R. Bloomberg,10,4,2,16
DeWitt,302,President,,Democratic Party,Elizabeth Warren,1,0,1,2
DeWitt,302,President,,Democratic Party,Andrew Yang,0,0,0,0
DeWitt,302,President,,Democratic Party,Tom Steyer,0,0,0,0
DeWitt,302,President,,Democratic Party,Pete Buttigieg,0,0,0,0
DeWitt,302,President,,Democratic Party,Tulsi Gabbard,0,0,0,0
DeWitt,302,President,,Democratic Party,Robby Wells,0,0,0,0
DeWitt,302,President,,Democratic Party,Deval Patrick,0,0,0,0
DeWitt,302,President,,Democratic Party,Bernie Sanders,3,0,2,5
DeWitt,302,President,,Democratic Party,"Roque ""Rocky"" De La Fuente Guerra",0,0,0,0
DeWitt,302,President,,Democratic Party,John K. Delaney,0,0,0,0
DeWitt,302,President,,Democratic Party,Cory Booker,0,0,0,0
DeWitt,302,President,,Democratic Party,Juli√°n Castro,0,1,0,1
DeWitt,302,Ballots Cast,,Democratic Party,,29,11,6,46
DeWitt,302,President,,Democratic Party,Undervotes,0,1,0,1
DeWitt,302,President,,Democratic Party,Overvotes,0,0,0,0
DeWitt,302,United States Senator,,Democratic Party,Victor Hugo Harris,4,0,0,4
DeWitt,302,United States Senator,,Democratic Party,"Annie ""Mam√°"" Garcia",5,3,3,11
DeWitt,302,United States Senator,,Democratic Party,Amanda K. Edwards,3,1,0,4
DeWitt,302,United States Senator,,Democratic Party,Royce West,0,0,0,0
DeWitt,302,United States Senator,,Democratic Party,Adrian Ocegueda,2,1,0,3
DeWitt,302,United States Senator,,Democratic Party,D.R. Hunter,3,0,0,3
DeWitt,302,United States Senator,,Democratic Party,Michael Cooper,4,0,0,4
DeWitt,302,United States Senator,,Democratic Party,Chris Bell,2,2,1,5
DeWitt,302,United States Senator,,Democratic Party,Cristina Tzintzun Ramirez,2,0,0,2
DeWitt,302,United States Senator,,Democratic Party,Sema Hernandez,0,1,2,3
DeWitt,302,United States Senator,,Democratic Party,Jack Daniel Foster Jr,0,1,0,1
DeWitt,302,United States Senator,,Democratic Party,"Mary ""MJ"" Hegar",2,2,0,4
DeWitt,302,Ballots Cast,,Democratic Party,,27,11,6,44
DeWitt,302,United States Senator,,Democratic Party,Undervotes,2,1,0,3
DeWitt,302,United States Senator,,Democratic Party,Overvotes,0,0,0,0
DeWitt,302,"United States Representative, District No. 34",,Democratic Party,Diego Zavala,8,2,1,11
DeWitt,302,"United States Representative, District No. 34",,Democratic Party,Osbert Haro,1,0,0,1
DeWitt,302,"United States Representative, District No. 34",,Democratic Party,Filemon B. Vela,16,8,4,28
DeWitt,302,Ballots Cast,,Democratic Party,,25,10,5,40
DeWitt,302,"United States Representative, District No. 34",,Democratic Party,Undervotes,4,2,1,7
DeWitt,302,"United States Representative, District No. 34",,Democratic Party,Overvotes,0,0,0,0
DeWitt,302,Railroad Commissioner,,Democratic Party,Chrysta Casta√±eda,8,0,3,11
DeWitt,302,Railroad Commissioner,,Democratic Party,Kelly Stone,3,2,0,5
DeWitt,302,Railroad Commissioner,,Democratic Party,Mark Watson,5,2,0,7
DeWitt,302,Railroad Commissioner,,Democratic Party,"Roberto R. ""Beto"" Alonzo",8,7,1,16
DeWitt,302,Ballots Cast,,Democratic Party,,24,11,4,39
DeWitt,302,Railroad Commissioner,,Democratic Party,Undervotes,5,1,2,8
DeWitt,302,Railroad Commissioner,,Democratic Party,Overvotes,0,0,0,0
DeWitt,302,"Chief Justice, Supreme Court",,Democratic Party,Jerry Zimmerer,12,4,0,16
DeWitt,302,"Chief Justice, Supreme Court",,Democratic Party,Amy Clark Meachum,14,5,4,23
DeWitt,302,Ballots Cast,,Democratic Party,,26,9,4,39
DeWitt,302,"Chief Justice, Supreme Court",,Democratic Party,Undervotes,3,3,2,8
DeWitt,302,"Chief Justice, Supreme Court",,Democratic Party,Overvotes,0,0,0,0
DeWitt,302,"Justice, Supreme Court, Place 6 Unexpired Term",,Democratic Party,Larry Praeger,10,5,0,15
DeWitt,302,"Justice, Supreme Court, Place 6 Unexpired Term",,Democratic Party,Kathy Cheng,15,5,5,25
DeWitt,302,Ballots Cast,,Democratic Party,,25,10,5,40
DeWitt,302,"Justice, Supreme Court, Place 6 Unexpired Term",,Democratic Party,Undervotes,4,2,1,7
DeWitt,302,"Justice, Supreme Court, Place 6 Unexpired Term",,Democratic Party,Overvotes,0,0,0,0
DeWitt,302,"Justice, Supreme Court, Place 7",,Democratic Party,Staci Williams,21,7,3,31
DeWitt,302,"Justice, Supreme Court, Place 7",,Democratic Party,Brandy Voss,4,3,2,9
DeWitt,302,Ballots Cast,,Democratic Party,,25,10,5,40
DeWitt,302,"Justice, Supreme Court, Place 7",,Democratic Party,Undervotes,4,2,1,7
DeWitt,302,"Justice, Supreme Court, Place 7",,Democratic Party,Overvotes,0,0,0,0
DeWitt,302,"Justice, Supreme Court, Place 8",,Democratic Party,Peter Kelly,12,9,1,22
DeWitt,302,"Justice, Supreme Court, Place 8",,Democratic Party,Gisela D. Triana,14,2,4,20
DeWitt,302,Ballots Cast,,Democratic Party,,26,11,5,42
DeWitt,302,"Justice, Supreme Court, Place 8",,Democratic Party,Undervotes,3,1,1,5
DeWitt,302,"Justice, Supreme Court, Place 8",,Democratic Party,Overvotes,0,0,0,0
DeWitt,302,"Judge, Court of Criminal Appeals, Place 3",,Democratic Party,Dan Wood,8,7,0,15
DeWitt,302,"Judge, Court of Criminal Appeals, Place 3",,Democratic Party,William Pieratt Demond,4,1,0,5
DeWitt,302,"Judge, Court of Criminal Appeals, Place 3",,Democratic Party,Elizabeth Davis Frizell,13,2,5,20
DeWitt,302,Ballots Cast,,Democratic Party,,25,10,5,40
DeWitt,302,"Judge, Court of Criminal Appeals, Place 3",,Democratic Party,Undervotes,4,2,1,7
DeWitt,302,"Judge, Court of Criminal Appeals, Place 3",,Democratic Party,Overvotes,0,0,0,0
DeWitt,302,"Judge, Court of Criminal Appeals, Place 4",,Democratic Party,Steven Miears,6,9,0,15
DeWitt,302,"Judge, Court of Criminal Appeals, Place 4",,Democratic Party,Tina Clinton,18,2,5,25
DeWitt,302,Ballots Cast,,Democratic Party,,24,11,5,40
DeWitt,302,"Judge, Court of Criminal Appeals, Place 4",,Democratic Party,Undervotes,5,1,1,7
DeWitt,302,"Judge, Court of Criminal Appeals, Place 4",,Democratic Party,Overvotes,0,0,0,0
DeWitt,302,"Judge, Court of Criminal Appeals, Place 9",,Democratic Party,Brandon Birmingham,24,10,4,38
DeWitt,302,Ballots Cast,,Democratic Party,,24,10,4,38
DeWitt,302,"Judge, Court of Criminal Appeals, Place 9",,Democratic Party,Undervotes,5,2,2,9
DeWitt,302,"Judge, Court of Criminal Appeals, Place 9",,Democratic Party,Overvotes,0,0,0,0
DeWitt,302,"State Senator, District 18",,Democratic Party,Michael Antalan,23,9,4,36
DeWitt,302,Ballots Cast,,Democratic Party,,23,9,4,36
DeWitt,302,"State Senator, District 18",,Democratic Party,Undervotes,6,3,2,11
DeWitt,302,"State Senator, District 18",,Democratic Party,Overvotes,0,0,0,0
DeWitt,302,County Chairman,,Democratic Party,Jospeh L. Sheppard,26,9,4,39
DeWitt,302,Ballots Cast,,Democratic Party,,26,9,4,39
DeWitt,302,County Chairman,,Democratic Party,Undervotes,3,3,2,8
DeWitt,302,County Chairman,,Democratic Party,Overvotes,0,0,0,0
DeWitt,302,President,,Republican Party,Zoltan G. Istvan,0,0,0,0
DeWitt,302,President,,Republican Party,Donald J. Trump,149,37,79,265
DeWitt,302,President,,Republican Party,Bill Weld,0,0,0,0
DeWitt,302,President,,Republican Party,Joe Walsh,2,0,0,2
DeWitt,302,President,,Republican Party,"Roque ""Rocky"" De La Fuente Guerra",0,0,1,1
DeWitt,302,President,,Republican Party,Matthew John Matern,0,0,0,0
DeWitt,302,President,,Republican Party,Bob Ely,0,0,0,0
DeWitt,302,President,,Republican Party,Uncommitted,5,1,4,10
DeWitt,302,Ballots Cast,,Republican Party,,156,38,84,278
DeWitt,302,President,,Republican Party,Undervotes,2,0,2,4
DeWitt,302,President,,Republican Party,Overvotes,0,0,0,0
DeWitt,302,United States Senator,,Republican Party,Dwayne Stovall,34,9,15,58
DeWitt,302,United States Senator,,Republican Party,Mark Yancey,6,1,7,14
DeWitt,302,United States Senator,,Republican Party,Virgil Bierschwale,2,0,1,3
DeWitt,302,United States Senator,,Republican Party,John Cornyn,96,25,50,171
DeWitt,302,United States Senator,,Republican Party,John Anthony Castro,9,1,2,12
DeWitt,302,Ballots Cast,,Republican Party,,147,36,75,258
DeWitt,302,United States Senator,,Republican Party,Undervotes,11,2,11,24
DeWitt,302,United States Senator,,Republican Party,Overvotes,0,0,0,0
DeWitt,302,"United States Representative, District No. 34",,Republican Party,Rey Gonzalez,84,20,38,142
DeWitt,302,"United States Representative, District No. 34",,Republican Party,Rod Lingsch,56,11,32,99
DeWitt,302,Ballots Cast,,Republican Party,,140,31,70,241
DeWitt,302,"United States Representative, District No. 34",,Republican Party,Undervotes,18,6,16,40
DeWitt,302,"United States Representative, District No. 34",,Republican Party,Overvotes,0,1,0,1
DeWitt,302,Railroad Commissioner,,Republican Party,Ryan Sitton,57,13,22,92
DeWitt,302,Railroad Commissioner,,Republican Party,"James ""Jim"" Wright",89,20,52,161
DeWitt,302,Ballots Cast,,Republican Party,,146,33,74,253
DeWitt,302,Railroad Commissioner,,Republican Party,Undervotes,12,5,12,29
DeWitt,302,Railroad Commissioner,,Republican Party,Overvotes,0,0,0,0
DeWitt,302,"Chief Justice, Supreme Court",,Republican Party,Nathan Hecht,140,33,70,243
DeWitt,302,Ballots Cast,,Republican Party,,140,33,70,243
DeWitt,302,"Chief Justice, Supreme Court",,Republican Party,Undervotes,18,5,16,39
DeWitt,302,"Chief Justice, Supreme Court",,Republican Party,Overvotes,0,0,0,0
DeWitt,302,"Justice, Supreme Court, Place 6 Unexpired Term",,Republican Party,Jane Bland,146,33,72,251
DeWitt,302,Ballots Cast,,Republican Party,,146,33,72,251
DeWitt,302,"Justice, Supreme Court, Place 6 Unexpired Term",,Republican Party,Undervotes,12,5,14,31
DeWitt,302,"Justice, Supreme Court, Place 6 Unexpired Term",,Republican Party,Overvotes,0,0,0,0
DeWitt,302,"Justice, Supreme Court, Place 7",,Republican Party,Jeff Boyd,142,33,72,247
DeWitt,302,Ballots Cast,,Republican Party,,142,33,72,247
DeWitt,302,"Justice, Supreme Court, Place 7",,Republican Party,Undervotes,16,5,14,35
DeWitt,302,"Justice, Supreme Court, Place 7",,Republican Party,Overvotes,0,0,0,0
DeWitt,302,"Justice, Supreme Court, Place 8",,Republican Party,Brett Busby,145,33,73,251
DeWitt,302,Ballots Cast,,Republican Party,,145,33,73,251
DeWitt,302,"Justice, Supreme Court, Place 8",,Republican Party,Undervotes,13,5,13,31
DeWitt,302,"Justice, Supreme Court, Place 8",,Republican Party,Overvotes,0,0,0,0
DeWitt,302,"Judge, Court of Criminal Appeals, Place 3",,Republican Party,Gina Parker,78,19,45,142
DeWitt,302,"Judge, Court of Criminal Appeals, Place 3",,Republican Party,Bert Richardson,56,12,28,96
DeWitt,302,Ballots Cast,,Republican Party,,134,31,73,238
DeWitt,302,"Judge, Court of Criminal Appeals, Place 3",,Republican Party,Undervotes,24,7,13,44
DeWitt,302,"Judge, Court of Criminal Appeals, Place 3",,Republican Party,Overvotes,0,0,0,0
DeWitt,302,"Judge, Court of Criminal Appeals, Place 4",,Republican Party,Kevin Patrick Yeary,141,33,72,246
DeWitt,302,Ballots Cast,,Republican Party,,141,33,72,246
DeWitt,302,"Judge, Court of Criminal Appeals, Place 4",,Republican Party,Undervotes,17,5,14,36
DeWitt,302,"Judge, Court of Criminal Appeals, Place 4",,Republican Party,Overvotes,0,0,0,0
DeWitt,302,"Judge, Court of Criminal Appeals, Place 9",,Republican Party,David Newell,141,33,72,246
DeWitt,302,Ballots Cast,,Republican Party,,141,33,72,246
DeWitt,302,"Judge, Court of Criminal Appeals, Place 9",,Republican Party,Undervotes,17,5,14,36
DeWitt,302,"Judge, Court of Criminal Appeals, Place 9",,Republican Party,Overvotes,0,0,0,0
DeWitt,302,"State Senator, District 18",,Republican Party,Lois W. Kolkhorst,145,33,77,255
DeWitt,302,Ballots Cast,,Republican Party,,145,33,77,255
DeWitt,302,"State Senator, District 18",,Republican Party,Undervotes,13,5,9,27
DeWitt,302,"State Senator, District 18",,Republican Party,Overvotes,0,0,0,0
DeWitt,302,"State Representative, District 30",,Republican Party,Geanie W. Morrison,108,36,68,212
DeWitt,302,"State Representative, District 30",,Republican Party,Vanessa Hicks-Callaway,39,1,12,52
DeWitt,302,Ballots Cast,,Republican Party,,147,37,80,264
DeWitt,302,"State Representative, District 30",,Republican Party,Undervotes,11,1,6,18
DeWitt,302,"State Representative, District 30",,Republican Party,Overvotes,0,0,0,0
DeWitt,302,"District Attorney, 24th Judicial District",,Republican Party,"Robert C. ""Rob"" Lassman",145,33,73,251
DeWitt,302,Ballots Cast,,Republican Party,,145,33,73,251
DeWitt,302,"District Attorney, 24th Judicial District",,Republican Party,Undervotes,13,5,13,31
DeWitt,302,"District Attorney, 24th Judicial District",,Republican Party,Overvotes,0,0,0,0
DeWitt,302,County Attorney,,Republican Party,Jay Condie,143,33,77,253
DeWitt,302,Ballots Cast,,Republican Party,,143,33,77,253
DeWitt,302,County Attorney,,Republican Party,Undervotes,15,5,9,29
DeWitt,302,County Attorney,,Republican Party,Overvotes,0,0,0,0
DeWitt,302,Sheriff,,Republican Party,Carl R. Bowen,147,34,77,258
DeWitt,302,Ballots Cast,,Republican Party,,147,34,77,258
DeWitt,302,Sheriff,,Republican Party,Undervotes,11,4,9,24
DeWitt,302,Sheriff,,Republican Party,Overvotes,0,0,0,0
DeWitt,302,County Tax Assessor-Collector,,Republican Party,Ashley D. Mraz,114,31,69,214
DeWitt,302,County Tax Assessor-Collector,,Republican Party,Guy Dolan,36,4,14,54
DeWitt,302,Ballots Cast,,Republican Party,,150,35,83,268
DeWitt,302,County Tax Assessor-Collector,,Republican Party,Undervotes,8,3,3,14
DeWitt,302,County Tax Assessor-Collector,,Republican Party,Overvotes,0,0,0,0
DeWitt,302,"County Commissioner, Precinct 3",,Republican Party,James Kaiser,145,35,73,253
DeWitt,302,Ballots Cast,,Republican Party,,145,35,73,253
DeWitt,302,"County Commissioner, Precinct 3",,Republican Party,Undervotes,13,3,13,29
DeWitt,302,"County Commissioner, Precinct 3",,Republican Party,Overvotes,0,0,0,0
DeWitt,302,"Constable, Precinct 2",,Republican Party,Jefferson Hobbs,85,18,63,166
DeWitt,302,"Constable, Precinct 2",,Republican Party,Jeff Abbott,64,16,17,97
DeWitt,302,Ballots Cast,,Republican Party,,149,34,80,263
DeWitt,302,"Constable, Precinct 2",,Republican Party,Undervotes,9,4,6,19
DeWitt,302,"Constable, Precinct 2",,Republican Party,Overvotes,0,0,0,0
DeWitt,302,County Chairman,,Republican Party,Paul Guidry,142,34,76,252
DeWitt,302,Ballots Cast,,Republican Party,,142,34,76,252
DeWitt,302,County Chairman,,Republican Party,Undervotes,16,4,10,30
DeWitt,302,County Chairman,,Republican Party,Overvotes,0,0,0,0
DeWitt,302,Proposition #1,,Democratic Party,Yes,27,9,5,41
DeWitt,302,Proposition #1,,Democratic Party,No,1,3,0,4
DeWitt,302,Ballots Cast,,Democratic Party,,28,12,5,45
DeWitt,302,Proposition #1,,Democratic Party,Undervotes,1,0,1,2
DeWitt,302,Proposition #1,,Democratic Party,Overvotes,0,0,0,0
DeWitt,302,Proposition #2,,Democratic Party,Yes,27,8,5,40
DeWitt,302,Proposition #2,,Democratic Party,No,0,3,0,3
DeWitt,302,Ballots Cast,,Democratic Party,,27,11,5,43
DeWitt,302,Proposition #2,,Democratic Party,Undervotes,2,1,1,4
DeWitt,302,Proposition #2,,Democratic Party,Overvotes,0,0,0,0
DeWitt,302,Proposition #3,,Democratic Party,Yes,28,11,5,44
DeWitt,302,Proposition #3,,Democratic Party,No,0,0,0,0
DeWitt,302,Ballots Cast,,Democratic Party,,28,11,5,44
DeWitt,302,Proposition #3,,Democratic Party,Undervotes,1,1,1,3
DeWitt,302,Proposition #3,,Democratic Party,Overvotes,0,0,0,0
DeWitt,302,Proposition #4,,Democratic Party,Yes,28,10,5,43
DeWitt,302,Proposition #4,,Democratic Party,No,1,1,0,2
DeWitt,302,Ballots Cast,,Democratic Party,,29,11,5,45
DeWitt,302,Proposition #4,,Democratic Party,Undervotes,0,1,1,2
DeWitt,302,Proposition #4,,Democratic Party,Overvotes,0,0,0,0
DeWitt,302,Proposition #5,,Democratic Party,Yes,28,11,5,44
DeWitt,302,Proposition #5,,Democratic Party,No,0,0,0,0
DeWitt,302,Ballots Cast,,Democratic Party,,28,11,5,44
DeWitt,302,Proposition #5,,Democratic Party,Undervotes,1,1,1,3
DeWitt,302,Proposition #5,,Democratic Party,Overvotes,0,0,0,0
DeWitt,302,Proposition #6,,Democratic Party,Yes,28,10,5,43
DeWitt,302,Proposition #6,,Democratic Party,No,0,1,0,1
DeWitt,302,Ballots Cast,,Democratic Party,,28,11,5,44
DeWitt,302,Proposition #6,,Democratic Party,Undervotes,1,1,1,3
DeWitt,302,Proposition #6,,Democratic Party,Overvotes,0,0,0,0
DeWitt,302,Proposition #7,,Democratic Party,Yes,25,11,5,41
DeWitt,302,Proposition #7,,Democratic Party,No,2,0,0,2
DeWitt,302,Ballots Cast,,Democratic Party,,27,11,5,43
DeWitt,302,Proposition #7,,Democratic Party,Undervotes,2,1,1,4
DeWitt,302,Proposition #7,,Democratic Party,Overvotes,0,0,0,0
DeWitt,302,Proposition #8,,Democratic Party,Yes,28,10,5,43
DeWitt,302,Proposition #8,,Democratic Party,No,0,1,0,1
DeWitt,302,Ballots Cast,,Democratic Party,,28,11,5,44
DeWitt,302,Proposition #8,,Democratic Party,Undervotes,1,1,1,3
DeWitt,302,Proposition #8,,Democratic Party,Overvotes,0,0,0,0
DeWitt,302,Proposition #9,,Democratic Party,Yes,28,9,5,42
DeWitt,302,Proposition #9,,Democratic Party,No,0,2,0,2
DeWitt,302,Ballots Cast,,Democratic Party,,28,11,5,44
DeWitt,302,Proposition #9,,Democratic Party,Undervotes,1,1,1,3
DeWitt,302,Proposition #9,,Democratic Party,Overvotes,0,0,0,0
DeWitt,302,Proposition #10,,Democratic Party,Yes,26,9,5,40
DeWitt,302,Proposition #10,,Democratic Party,No,2,2,0,4
DeWitt,302,Ballots Cast,,Democratic Party,,28,11,5,44
DeWitt,302,Proposition #10,,Democratic Party,Undervotes,1,1,1,3
DeWitt,302,Proposition #10,,Democratic Party,Overvotes,0,0,0,0
DeWitt,302,Proposition #11,,Democratic Party,Yes,25,8,5,38
DeWitt,302,Proposition #11,,Democratic Party,No,2,3,0,5
DeWitt,302,Ballots Cast,,Democratic Party,,27,11,5,43
DeWitt,302,Proposition #11,,Democratic Party,Undervotes,2,1,1,4
DeWitt,302,Proposition #11,,Democratic Party,Overvotes,0,0,0,0
DeWitt,302,Proposition 1,,Republican Party,Yes,140,35,69,244
DeWitt,302,Proposition 1,,Republican Party,No,13,2,13,28
DeWitt,302,Ballots Cast,,Republican Party,,153,37,82,272
DeWitt,302,Proposition 1,,Republican Party,Undervotes,5,1,4,10
DeWitt,302,Proposition 1,,Republican Party,Overvotes,0,0,0,0
DeWitt,302,Proposition 2,,Republican Party,Yes,134,34,69,237
DeWitt,302,Proposition 2,,Republican Party,No,20,3,11,34
DeWitt,302,Ballots Cast,,Republican Party,,154,37,80,271
DeWitt,302,Proposition 2,,Republican Party,Undervotes,4,1,6,11
DeWitt,302,Proposition 2,,Republican Party,Overvotes,0,0,0,0
DeWitt,302,Proposition 3,,Republican Party,Yes,143,36,72,251
DeWitt,302,Proposition 3,,Republican Party,No,9,0,9,18
DeWitt,302,Ballots Cast,,Republican Party,,152,36,81,269
DeWitt,302,Proposition 3,,Republican Party,Undervotes,6,1,5,12
DeWitt,302,Proposition 3,,Republican Party,Overvotes,0,1,0,1
DeWitt,302,Proposition 4,,Republican Party,Yes,148,35,78,261
DeWitt,302,Proposition 4,,Republican Party,No,8,2,2,12
DeWitt,302,Ballots Cast,,Republican Party,,156,37,80,273
DeWitt,302,Proposition 4,,Republican Party,Undervotes,2,1,6,9
DeWitt,302,Proposition 4,,Republican Party,Overvotes,0,0,0,0
DeWitt,302,Proposition 5,,Republican Party,Yes,137,33,75,245
DeWitt,302,Proposition 5,,Republican Party,No,13,4,5,22
DeWitt,302,Ballots Cast,,Republican Party,,150,37,80,267
DeWitt,302,Proposition 5,,Republican Party,Undervotes,8,1,6,15
DeWitt,302,Proposition 5,,Republican Party,Overvotes,0,0,0,0
DeWitt,302,Proposition 6,,Republican Party,Yes,141,33,77,251
DeWitt,302,Proposition 6,,Republican Party,No,9,4,3,16
DeWitt,302,Ballots Cast,,Republican Party,,150,37,80,267
DeWitt,302,Proposition 6,,Republican Party,Undervotes,8,1,6,15
DeWitt,302,Proposition 6,,Republican Party,Overvotes,0,0,0,0
DeWitt,302,Proposition 7,,Republican Party,Yes,151,37,79,267
DeWitt,302,Proposition 7,,Republican Party,No,2,0,3,5
DeWitt,302,Ballots Cast,,Republican Party,,153,37,82,272
DeWitt,302,Proposition 7,,Republican Party,Undervotes,5,1,4,10
DeWitt,302,Proposition 7,,Republican Party,Overvotes,0,0,0,0
DeWitt,302,Proposition 8,,Republican Party,Yes,150,37,80,267
DeWitt,302,Proposition 8,,Republican Party,No,1,0,1,2
DeWitt,302,Ballots Cast,,Republican Party,,151,37,81,269
DeWitt,302,Proposition 8,,Republican Party,Undervotes,7,1,5,13
DeWitt,302,Proposition 8,,Republican Party,Overvotes,0,0,0,0
DeWitt,302,Proposition 9,,Republican Party,Yes,139,37,76,252
DeWitt,302,Proposition 9,,Republican Party,No,11,0,4,15
DeWitt,302,Ballots Cast,,Republican Party,,150,37,80,267
DeWitt,302,Proposition 9,,Republican Party,Undervotes,8,1,6,15
DeWitt,302,Proposition 9,,Republican Party,Overvotes,0,0,0,0
DeWitt,302,Proposition 10,,Republican Party,Yes,135,35,76,246
DeWitt,302,Proposition 10,,Republican Party,No,13,2,5,20
DeWitt,302,Ballots Cast,,Republican Party,,148,37,81,266
DeWitt,302,Proposition 10,,Republican Party,Undervotes,10,1,5,16
DeWitt,302,Proposition 10,,Republican Party,Overvotes,0,0,0,0
DeWitt,303,President,,Democratic Party,Amy Klobuchar,0,0,0,0
DeWitt,303,President,,Democratic Party,Joseph R. Biden,7,1,0,8
DeWitt,303,President,,Democratic Party,Michael Bennet,0,0,0,0
DeWitt,303,President,,Democratic Party,Marianne Williamson,0,0,0,0
DeWitt,303,President,,Democratic Party,Michael R. Bloomberg,0,2,0,2
DeWitt,303,President,,Democratic Party,Elizabeth Warren,0,0,0,0
DeWitt,303,President,,Democratic Party,Andrew Yang,0,0,0,0
DeWitt,303,President,,Democratic Party,Tom Steyer,0,0,0,0
DeWitt,303,President,,Democratic Party,Pete Buttigieg,0,0,0,0
DeWitt,303,President,,Democratic Party,Tulsi Gabbard,0,0,0,0
DeWitt,303,President,,Democratic Party,Robby Wells,0,0,0,0
DeWitt,303,President,,Democratic Party,Deval Patrick,0,0,0,0
DeWitt,303,President,,Democratic Party,Bernie Sanders,7,0,3,10
DeWitt,303,President,,Democratic Party,"Roque ""Rocky"" De La Fuente Guerra",0,0,0,0
DeWitt,303,President,,Democratic Party,John K. Delaney,0,0,0,0
DeWitt,303,President,,Democratic Party,Cory Booker,0,0,0,0
DeWitt,303,President,,Democratic Party,Juli√°n Castro,0,0,0,0
DeWitt,303,Ballots Cast,,Democratic Party,,14,3,3,20
DeWitt,303,President,,Democratic Party,Undervotes,1,0,0,1
DeWitt,303,President,,Democratic Party,Overvotes,0,0,0,0
DeWitt,303,United States Senator,,Democratic Party,Victor Hugo Harris,1,0,0,1
DeWitt,303,United States Senator,,Democratic Party,"Annie ""Mam√°"" Garcia",5,1,1,7
DeWitt,303,United States Senator,,Democratic Party,Amanda K. Edwards,0,1,0,1
DeWitt,303,United States Senator,,Democratic Party,Royce West,0,0,0,0
DeWitt,303,United States Senator,,Democratic Party,Adrian Ocegueda,0,0,0,0
DeWitt,303,United States Senator,,Democratic Party,D.R. Hunter,1,0,0,1
DeWitt,303,United States Senator,,Democratic Party,Michael Cooper,0,0,0,0
DeWitt,303,United States Senator,,Democratic Party,Chris Bell,1,0,1,2
DeWitt,303,United States Senator,,Democratic Party,Cristina Tzintzun Ramirez,2,0,1,3
DeWitt,303,United States Senator,,Democratic Party,Sema Hernandez,2,0,0,2
DeWitt,303,United States Senator,,Democratic Party,Jack Daniel Foster Jr,0,0,0,0
DeWitt,303,United States Senator,,Democratic Party,"Mary ""MJ"" Hegar",0,0,0,0
DeWitt,303,Ballots Cast,,Democratic Party,,12,2,3,17
DeWitt,303,United States Senator,,Democratic Party,Undervotes,3,1,0,4
DeWitt,303,United States Senator,,Democratic Party,Overvotes,0,0,0,0
DeWitt,303,"United States Representative, District No. 34",,Democratic Party,Diego Zavala,7,0,0,7
DeWitt,303,"United States Representative, District No. 34",,Democratic Party,Osbert Haro,1,0,0,1
DeWitt,303,"United States Representative, District No. 34",,Democratic Party,Filemon B. Vela,4,2,3,9
DeWitt,303,Ballots Cast,,Democratic Party,,12,2,3,17
DeWitt,303,"United States Representative, District No. 34",,Democratic Party,Undervotes,3,1,0,4
DeWitt,303,"United States Representative, District No. 34",,Democratic Party,Overvotes,0,0,0,0
DeWitt,303,Railroad Commissioner,,Democratic Party,Chrysta Casta√±eda,5,2,1,8
DeWitt,303,Railroad Commissioner,,Democratic Party,Kelly Stone,2,0,0,2
DeWitt,303,Railroad Commissioner,,Democratic Party,Mark Watson,2,0,1,3
DeWitt,303,Railroad Commissioner,,Democratic Party,"Roberto R. ""Beto"" Alonzo",3,0,1,4
DeWitt,303,Ballots Cast,,Democratic Party,,12,2,3,17
DeWitt,303,Railroad Commissioner,,Democratic Party,Undervotes,3,1,0,4
DeWitt,303,Railroad Commissioner,,Democratic Party,Overvotes,0,0,0,0
DeWitt,303,"Chief Justice, Supreme Court",,Democratic Party,Jerry Zimmerer,4,0,1,5
DeWitt,303,"Chief Justice, Supreme Court",,Democratic Party,Amy Clark Meachum,8,2,2,12
DeWitt,303,Ballots Cast,,Democratic Party,,12,2,3,17
DeWitt,303,"Chief Justice, Supreme Court",,Democratic Party,Undervotes,3,1,0,4
DeWitt,303,"Chief Justice, Supreme Court",,Democratic Party,Overvotes,0,0,0,0
DeWitt,303,"Justice, Supreme Court, Place 6 Unexpired Term",,Democratic Party,Larry Praeger,4,1,1,6
DeWitt,303,"Justice, Supreme Court, Place 6 Unexpired Term",,Democratic Party,Kathy Cheng,8,1,2,11
DeWitt,303,Ballots Cast,,Democratic Party,,12,2,3,17
DeWitt,303,"Justice, Supreme Court, Place 6 Unexpired Term",,Democratic Party,Undervotes,3,1,0,4
DeWitt,303,"Justice, Supreme Court, Place 6 Unexpired Term",,Democratic Party,Overvotes,0,0,0,0
DeWitt,303,"Justice, Supreme Court, Place 7",,Democratic Party,Staci Williams,9,0,2,11
DeWitt,303,"Justice, Supreme Court, Place 7",,Democratic Party,Brandy Voss,2,2,1,5
DeWitt,303,Ballots Cast,,Democratic Party,,11,2,3,16
DeWitt,303,"Justice, Supreme Court, Place 7",,Democratic Party,Undervotes,4,1,0,5
DeWitt,303,"Justice, Supreme Court, Place 7",,Democratic Party,Overvotes,0,0,0,0
DeWitt,303,"Justice, Supreme Court, Place 8",,Democratic Party,Peter Kelly,3,1,3,7
DeWitt,303,"Justice, Supreme Court, Place 8",,Democratic Party,Gisela D. Triana,8,1,0,9
DeWitt,303,Ballots Cast,,Democratic Party,,11,2,3,16
DeWitt,303,"Justice, Supreme Court, Place 8",,Democratic Party,Undervotes,4,1,0,5
DeWitt,303,"Justice, Supreme Court, Place 8",,Democratic Party,Overvotes,0,0,0,0
DeWitt,303,"Judge, Court of Criminal Appeals, Place 3",,Democratic Party,Dan Wood,3,0,1,4
DeWitt,303,"Judge, Court of Criminal Appeals, Place 3",,Democratic Party,William Pieratt Demond,1,0,1,2
DeWitt,303,"Judge, Court of Criminal Appeals, Place 3",,Democratic Party,Elizabeth Davis Frizell,8,2,1,11
DeWitt,303,Ballots Cast,,Democratic Party,,12,2,3,17
DeWitt,303,"Judge, Court of Criminal Appeals, Place 3",,Democratic Party,Undervotes,3,1,0,4
DeWitt,303,"Judge, Court of Criminal Appeals, Place 3",,Democratic Party,Overvotes,0,0,0,0
DeWitt,303,"Judge, Court of Criminal Appeals, Place 4",,Democratic Party,Steven Miears,4,1,0,5
DeWitt,303,"Judge, Court of Criminal Appeals, Place 4",,Democratic Party,Tina Clinton,8,1,2,11
DeWitt,303,Ballots Cast,,Democratic Party,,12,2,2,16
DeWitt,303,"Judge, Court of Criminal Appeals, Place 4",,Democratic Party,Undervotes,3,1,1,5
DeWitt,303,"Judge, Court of Criminal Appeals, Place 4",,Democratic Party,Overvotes,0,0,0,0
DeWitt,303,"Judge, Court of Criminal Appeals, Place 9",,Democratic Party,Brandon Birmingham,11,2,2,15
DeWitt,303,Ballots Cast,,Democratic Party,,11,2,2,15
DeWitt,303,"Judge, Court of Criminal Appeals, Place 9",,Democratic Party,Undervotes,4,1,1,6
DeWitt,303,"Judge, Court of Criminal Appeals, Place 9",,Democratic Party,Overvotes,0,0,0,0
DeWitt,303,"State Senator, District 18",,Democratic Party,Michael Antalan,12,1,2,15
DeWitt,303,Ballots Cast,,Democratic Party,,12,1,2,15
DeWitt,303,"State Senator, District 18",,Democratic Party,Undervotes,3,2,1,6
DeWitt,303,"State Senator, District 18",,Democratic Party,Overvotes,0,0,0,0
DeWitt,303,County Chairman,,Democratic Party,Jospeh L. Sheppard,12,1,1,14
DeWitt,303,Ballots Cast,,Democratic Party,,12,1,1,14
DeWitt,303,County Chairman,,Democratic Party,Undervotes,3,2,2,7
DeWitt,303,County Chairman,,Democratic Party,Overvotes,0,0,0,0
DeWitt,303,President,,Republican Party,Zoltan G. Istvan,1,0,0,1
DeWitt,303,President,,Republican Party,Donald J. Trump,74,16,20,110
DeWitt,303,President,,Republican Party,Bill Weld,0,0,0,0
DeWitt,303,President,,Republican Party,Joe Walsh,2,0,0,2
DeWitt,303,President,,Republican Party,"Roque ""Rocky"" De La Fuente Guerra",0,0,0,0
DeWitt,303,President,,Republican Party,Matthew John Matern,1,0,0,1
DeWitt,303,President,,Republican Party,Bob Ely,0,0,0,0
DeWitt,303,President,,Republican Party,Uncommitted,0,1,2,3
DeWitt,303,Ballots Cast,,Republican Party,,78,17,22,117
DeWitt,303,President,,Republican Party,Undervotes,0,0,0,0
DeWitt,303,President,,Republican Party,Overvotes,0,1,0,1
DeWitt,303,United States Senator,,Republican Party,Dwayne Stovall,13,3,4,20
DeWitt,303,United States Senator,,Republican Party,Mark Yancey,5,1,0,6
DeWitt,303,United States Senator,,Republican Party,Virgil Bierschwale,1,0,0,1
DeWitt,303,United States Senator,,Republican Party,John Cornyn,50,11,16,77
DeWitt,303,United States Senator,,Republican Party,John Anthony Castro,3,0,1,4
DeWitt,303,Ballots Cast,,Republican Party,,72,15,21,108
DeWitt,303,United States Senator,,Republican Party,Undervotes,6,2,1,9
DeWitt,303,United States Senator,,Republican Party,Overvotes,0,1,0,1
DeWitt,303,"United States Representative, District No. 34",,Republican Party,Rey Gonzalez,43,3,9,55
DeWitt,303,"United States Representative, District No. 34",,Republican Party,Rod Lingsch,23,9,10,42
DeWitt,303,Ballots Cast,,Republican Party,,66,12,19,97
DeWitt,303,"United States Representative, District No. 34",,Republican Party,Undervotes,12,5,3,20
DeWitt,303,"United States Representative, District No. 34",,Republican Party,Overvotes,0,1,0,1
DeWitt,303,Railroad Commissioner,,Republican Party,Ryan Sitton,26,6,6,38
DeWitt,303,Railroad Commissioner,,Republican Party,"James ""Jim"" Wright",44,7,13,64
DeWitt,303,Ballots Cast,,Republican Party,,70,13,19,102
DeWitt,303,Railroad Commissioner,,Republican Party,Undervotes,8,4,3,15
DeWitt,303,Railroad Commissioner,,Republican Party,Overvotes,0,1,0,1
DeWitt,303,"Chief Justice, Supreme Court",,Republican Party,Nathan Hecht,62,12,20,94
DeWitt,303,Ballots Cast,,Republican Party,,62,12,20,94
DeWitt,303,"Chief Justice, Supreme Court",,Republican Party,Undervotes,16,6,2,24
DeWitt,303,"Chief Justice, Supreme Court",,Republican Party,Overvotes,0,0,0,0
DeWitt,303,"Justice, Supreme Court, Place 6 Unexpired Term",,Republican Party,Jane Bland,63,11,19,93
DeWitt,303,Ballots Cast,,Republican Party,,63,11,19,93
DeWitt,303,"Justice, Supreme Court, Place 6 Unexpired Term",,Republican Party,Undervotes,15,7,3,25
DeWitt,303,"Justice, Supreme Court, Place 6 Unexpired Term",,Republican Party,Overvotes,0,0,0,0
DeWitt,303,"Justice, Supreme Court, Place 7",,Republican Party,Jeff Boyd,61,12,20,93
DeWitt,303,Ballots Cast,,Republican Party,,61,12,20,93
DeWitt,303,"Justice, Supreme Court, Place 7",,Republican Party,Undervotes,17,6,2,25
DeWitt,303,"Justice, Supreme Court, Place 7",,Republican Party,Overvotes,0,0,0,0
DeWitt,303,"Justice, Supreme Court, Place 8",,Republican Party,Brett Busby,63,11,20,94
DeWitt,303,Ballots Cast,,Republican Party,,63,11,20,94
DeWitt,303,"Justice, Supreme Court, Place 8",,Republican Party,Undervotes,15,7,2,24
DeWitt,303,"Justice, Supreme Court, Place 8",,Republican Party,Overvotes,0,0,0,0
DeWitt,303,"Judge, Court of Criminal Appeals, Place 3",,Republican Party,Gina Parker,32,5,8,45
DeWitt,303,"Judge, Court of Criminal Appeals, Place 3",,Republican Party,Bert Richardson,30,5,10,45
DeWitt,303,Ballots Cast,,Republican Party,,62,10,18,90
DeWitt,303,"Judge, Court of Criminal Appeals, Place 3",,Republican Party,Undervotes,16,7,4,27
DeWitt,303,"Judge, Court of Criminal Appeals, Place 3",,Republican Party,Overvotes,0,1,0,1
DeWitt,303,"Judge, Court of Criminal Appeals, Place 4",,Republican Party,Kevin Patrick Yeary,62,12,18,92
DeWitt,303,Ballots Cast,,Republican Party,,62,12,18,92
DeWitt,303,"Judge, Court of Criminal Appeals, Place 4",,Republican Party,Undervotes,16,6,4,26
DeWitt,303,"Judge, Court of Criminal Appeals, Place 4",,Republican Party,Overvotes,0,0,0,0
DeWitt,303,"Judge, Court of Criminal Appeals, Place 9",,Republican Party,David Newell,62,12,18,92
DeWitt,303,Ballots Cast,,Republican Party,,62,12,18,92
DeWitt,303,"Judge, Court of Criminal Appeals, Place 9",,Republican Party,Undervotes,16,6,4,26
DeWitt,303,"Judge, Court of Criminal Appeals, Place 9",,Republican Party,Overvotes,0,0,0,0
DeWitt,303,"State Senator, District 18",,Republican Party,Lois W. Kolkhorst,62,11,19,92
DeWitt,303,Ballots Cast,,Republican Party,,62,11,19,92
DeWitt,303,"State Senator, District 18",,Republican Party,Undervotes,16,7,3,26
DeWitt,303,"State Senator, District 18",,Republican Party,Overvotes,0,0,0,0
DeWitt,303,"State Representative, District 30",,Republican Party,Geanie W. Morrison,60,11,19,90
DeWitt,303,"State Representative, District 30",,Republican Party,Vanessa Hicks-Callaway,12,2,2,16
DeWitt,303,Ballots Cast,,Republican Party,,72,13,21,106
DeWitt,303,"State Representative, District 30",,Republican Party,Undervotes,6,4,1,11
DeWitt,303,"State Representative, District 30",,Republican Party,Overvotes,0,1,0,1
DeWitt,303,"District Attorney, 24th Judicial District",,Republican Party,"Robert C. ""Rob"" Lassman",67,12,18,97
DeWitt,303,Ballots Cast,,Republican Party,,67,12,18,97
DeWitt,303,"District Attorney, 24th Judicial District",,Republican Party,Undervotes,11,6,4,21
DeWitt,303,"District Attorney, 24th Judicial District",,Republican Party,Overvotes,0,0,0,0
DeWitt,303,County Attorney,,Republican Party,Jay Condie,63,11,19,93
DeWitt,303,Ballots Cast,,Republican Party,,63,11,19,93
DeWitt,303,County Attorney,,Republican Party,Undervotes,15,7,3,25
DeWitt,303,County Attorney,,Republican Party,Overvotes,0,0,0,0
DeWitt,303,Sheriff,,Republican Party,Carl R. Bowen,69,13,17,99
DeWitt,303,Ballots Cast,,Republican Party,,69,13,17,99
DeWitt,303,Sheriff,,Republican Party,Undervotes,9,5,5,19
DeWitt,303,Sheriff,,Republican Party,Overvotes,0,0,0,0
DeWitt,303,County Tax Assessor-Collector,,Republican Party,Ashley D. Mraz,56,9,14,79
DeWitt,303,County Tax Assessor-Collector,,Republican Party,Guy Dolan,14,3,6,23
DeWitt,303,Ballots Cast,,Republican Party,,70,12,20,102
DeWitt,303,County Tax Assessor-Collector,,Republican Party,Undervotes,8,5,2,15
DeWitt,303,County Tax Assessor-Collector,,Republican Party,Overvotes,0,1,0,1
DeWitt,303,"County Commissioner, Precinct 3",,Republican Party,James Kaiser,63,12,19,94
DeWitt,303,Ballots Cast,,Republican Party,,63,12,19,94
DeWitt,303,"County Commissioner, Precinct 3",,Republican Party,Undervotes,15,6,3,24
DeWitt,303,"County Commissioner, Precinct 3",,Republican Party,Overvotes,0,0,0,0
DeWitt,303,"Constable, Precinct 2",,Republican Party,Jefferson Hobbs,44,7,5,56
DeWitt,303,"Constable, Precinct 2",,Republican Party,Jeff Abbott,27,4,14,45
DeWitt,303,Ballots Cast,,Republican Party,,71,11,19,101
DeWitt,303,"Constable, Precinct 2",,Republican Party,Undervotes,7,6,3,16
DeWitt,303,"Constable, Precinct 2",,Republican Party,Overvotes,0,1,0,1
DeWitt,303,County Chairman,,Republican Party,Paul Guidry,64,14,17,95
DeWitt,303,Ballots Cast,,Republican Party,,64,14,17,95
DeWitt,303,County Chairman,,Republican Party,Undervotes,14,4,5,23
DeWitt,303,County Chairman,,Republican Party,Overvotes,0,0,0,0
DeWitt,303,Proposition #1,,Democratic Party,Yes,14,3,2,19
DeWitt,303,Proposition #1,,Democratic Party,No,0,0,1,1
DeWitt,303,Ballots Cast,,Democratic Party,,14,3,3,20
DeWitt,303,Proposition #1,,Democratic Party,Undervotes,1,0,0,1
DeWitt,303,Proposition #1,,Democratic Party,Overvotes,0,0,0,0
DeWitt,303,Proposition #2,,Democratic Party,Yes,13,3,3,19
DeWitt,303,Proposition #2,,Democratic Party,No,0,0,0,0
DeWitt,303,Ballots Cast,,Democratic Party,,13,3,3,19
DeWitt,303,Proposition #2,,Democratic Party,Undervotes,2,0,0,2
DeWitt,303,Proposition #2,,Democratic Party,Overvotes,0,0,0,0
DeWitt,303,Proposition #3,,Democratic Party,Yes,15,3,3,21
DeWitt,303,Proposition #3,,Democratic Party,No,0,0,0,0
DeWitt,303,Ballots Cast,,Democratic Party,,15,3,3,21
DeWitt,303,Proposition #3,,Democratic Party,Undervotes,0,0,0,0
DeWitt,303,Proposition #3,,Democratic Party,Overvotes,0,0,0,0
DeWitt,303,Proposition #4,,Democratic Party,Yes,13,3,2,18
DeWitt,303,Proposition #4,,Democratic Party,No,1,0,1,2
DeWitt,303,Ballots Cast,,Democratic Party,,14,3,3,20
DeWitt,303,Proposition #4,,Democratic Party,Undervotes,1,0,0,1
DeWitt,303,Proposition #4,,Democratic Party,Overvotes,0,0,0,0
DeWitt,303,Proposition #5,,Democratic Party,Yes,14,3,2,19
DeWitt,303,Proposition #5,,Democratic Party,No,0,0,1,1
DeWitt,303,Ballots Cast,,Democratic Party,,14,3,3,20
DeWitt,303,Proposition #5,,Democratic Party,Undervotes,1,0,0,1
DeWitt,303,Proposition #5,,Democratic Party,Overvotes,0,0,0,0
DeWitt,303,Proposition #6,,Democratic Party,Yes,13,3,2,18
DeWitt,303,Proposition #6,,Democratic Party,No,0,0,1,1
DeWitt,303,Ballots Cast,,Democratic Party,,13,3,3,19
DeWitt,303,Proposition #6,,Democratic Party,Undervotes,2,0,0,2
DeWitt,303,Proposition #6,,Democratic Party,Overvotes,0,0,0,0
DeWitt,303,Proposition #7,,Democratic Party,Yes,14,3,2,19
DeWitt,303,Proposition #7,,Democratic Party,No,0,0,1,1
DeWitt,303,Ballots Cast,,Democratic Party,,14,3,3,20
DeWitt,303,Proposition #7,,Democratic Party,Undervotes,1,0,0,1
DeWitt,303,Proposition #7,,Democratic Party,Overvotes,0,0,0,0
DeWitt,303,Proposition #8,,Democratic Party,Yes,13,3,3,19
DeWitt,303,Proposition #8,,Democratic Party,No,0,0,0,0
DeWitt,303,Ballots Cast,,Democratic Party,,13,3,3,19
DeWitt,303,Proposition #8,,Democratic Party,Undervotes,2,0,0,2
DeWitt,303,Proposition #8,,Democratic Party,Overvotes,0,0,0,0
DeWitt,303,Proposition #9,,Democratic Party,Yes,13,3,3,19
DeWitt,303,Proposition #9,,Democratic Party,No,0,0,0,0
DeWitt,303,Ballots Cast,,Democratic Party,,13,3,3,19
DeWitt,303,Proposition #9,,Democratic Party,Undervotes,2,0,0,2
DeWitt,303,Proposition #9,,Democratic Party,Overvotes,0,0,0,0
DeWitt,303,Proposition #10,,Democratic Party,Yes,13,3,3,19
DeWitt,303,Proposition #10,,Democratic Party,No,0,0,0,0
DeWitt,303,Ballots Cast,,Democratic Party,,13,3,3,19
DeWitt,303,Proposition #10,,Democratic Party,Undervotes,2,0,0,2
DeWitt,303,Proposition #10,,Democratic Party,Overvotes,0,0,0,0
DeWitt,303,Proposition #11,,Democratic Party,Yes,14,3,3,20
DeWitt,303,Proposition #11,,Democratic Party,No,0,0,0,0
DeWitt,303,Ballots Cast,,Democratic Party,,14,3,3,20
DeWitt,303,Proposition #11,,Democratic Party,Undervotes,1,0,0,1
DeWitt,303,Proposition #11,,Democratic Party,Overvotes,0,0,0,0
DeWitt,303,Proposition 1,,Republican Party,Yes,68,16,17,101
DeWitt,303,Proposition 1,,Republican Party,No,7,2,3,12
DeWitt,303,Ballots Cast,,Republican Party,,75,18,20,113
DeWitt,303,Proposition 1,,Republican Party,Undervotes,3,0,2,5
DeWitt,303,Proposition 1,,Republican Party,Overvotes,0,0,0,0
DeWitt,303,Proposition 2,,Republican Party,Yes,65,12,18,95
DeWitt,303,Proposition 2,,Republican Party,No,10,4,4,18
DeWitt,303,Ballots Cast,,Republican Party,,75,16,22,113
DeWitt,303,Proposition 2,,Republican Party,Undervotes,3,2,0,5
DeWitt,303,Proposition 2,,Republican Party,Overvotes,0,0,0,0
DeWitt,303,Proposition 3,,Republican Party,Yes,72,17,20,109
DeWitt,303,Proposition 3,,Republican Party,No,4,1,2,7
DeWitt,303,Ballots Cast,,Republican Party,,76,18,22,116
DeWitt,303,Proposition 3,,Republican Party,Undervotes,2,0,0,2
DeWitt,303,Proposition 3,,Republican Party,Overvotes,0,0,0,0
DeWitt,303,Proposition 4,,Republican Party,Yes,71,17,19,107
DeWitt,303,Proposition 4,,Republican Party,No,5,1,3,9
DeWitt,303,Ballots Cast,,Republican Party,,76,18,22,116
DeWitt,303,Proposition 4,,Republican Party,Undervotes,2,0,0,2
DeWitt,303,Proposition 4,,Republican Party,Overvotes,0,0,0,0
DeWitt,303,Proposition 5,,Republican Party,Yes,70,15,20,105
DeWitt,303,Proposition 5,,Republican Party,No,6,3,2,11
DeWitt,303,Ballots Cast,,Republican Party,,76,18,22,116
DeWitt,303,Proposition 5,,Republican Party,Undervotes,2,0,0,2
DeWitt,303,Proposition 5,,Republican Party,Overvotes,0,0,0,0
DeWitt,303,Proposition 6,,Republican Party,Yes,73,16,19,108
DeWitt,303,Proposition 6,,Republican Party,No,4,0,3,7
DeWitt,303,Ballots Cast,,Republican Party,,77,16,22,115
DeWitt,303,Proposition 6,,Republican Party,Undervotes,1,1,0,2
DeWitt,303,Proposition 6,,Republican Party,Overvotes,0,1,0,1
DeWitt,303,Proposition 7,,Republican Party,Yes,73,17,21,111
DeWitt,303,Proposition 7,,Republican Party,No,2,0,1,3
DeWitt,303,Ballots Cast,,Republican Party,,75,17,22,114
DeWitt,303,Proposition 7,,Republican Party,Undervotes,3,1,0,4
DeWitt,303,Proposition 7,,Republican Party,Overvotes,0,0,0,0
DeWitt,303,Proposition 8,,Republican Party,Yes,73,18,21,112
DeWitt,303,Proposition 8,,Republican Party,No,2,0,1,3
DeWitt,303,Ballots Cast,,Republican Party,,75,18,22,115
DeWitt,303,Proposition 8,,Republican Party,Undervotes,3,0,0,3
DeWitt,303,Proposition 8,,Republican Party,Overvotes,0,0,0,0
DeWitt,303,Proposition 9,,Republican Party,Yes,73,16,21,110
DeWitt,303,Proposition 9,,Republican Party,No,3,1,0,4
DeWitt,303,Ballots Cast,,Republican Party,,76,17,21,114
DeWitt,303,Proposition 9,,Republican Party,Undervotes,2,1,1,4
DeWitt,303,Proposition 9,,Republican Party,Overvotes,0,0,0,0
DeWitt,303,Proposition 10,,Republican Party,Yes,71,16,20,107
DeWitt,303,Proposition 10,,Republican Party,No,4,2,2,8
DeWitt,303,Ballots Cast,,Republican Party,,75,18,22,115
DeWitt,303,Proposition 10,,Republican Party,Undervotes,3,0,0,3
DeWitt,303,Proposition 10,,Republican Party,Overvotes,0,0,0,0
DeWitt,401,President,,Democratic Party,Amy Klobuchar,0,1,3,4
DeWitt,401,President,,Democratic Party,Joseph R. Biden,41,5,9,55
DeWitt,401,President,,Democratic Party,Michael Bennet,0,0,0,0
DeWitt,401,President,,Democratic Party,Marianne Williamson,0,0,0,0
DeWitt,401,President,,Democratic Party,Michael R. Bloomberg,3,7,6,16
DeWitt,401,President,,Democratic Party,Elizabeth Warren,3,0,4,7
DeWitt,401,President,,Democratic Party,Andrew Yang,0,0,0,0
DeWitt,401,President,,Democratic Party,Tom Steyer,0,1,2,3
DeWitt,401,President,,Democratic Party,Pete Buttigieg,0,0,0,0
DeWitt,401,President,,Democratic Party,Tulsi Gabbard,0,0,0,0
DeWitt,401,President,,Democratic Party,Robby Wells,0,0,0,0
DeWitt,401,President,,Democratic Party,Deval Patrick,0,0,0,0
DeWitt,401,President,,Democratic Party,Bernie Sanders,11,3,13,27
DeWitt,401,President,,Democratic Party,"Roque ""Rocky"" De La Fuente Guerra",0,0,0,0
DeWitt,401,President,,Democratic Party,John K. Delaney,0,0,0,0
DeWitt,401,President,,Democratic Party,Cory Booker,0,0,0,0
DeWitt,401,President,,Democratic Party,Juli√°n Castro,0,0,0,0
DeWitt,401,Ballots Cast,,Democratic Party,,58,17,37,112
DeWitt,401,President,,Democratic Party,Undervotes,0,2,0,2
DeWitt,401,President,,Democratic Party,Overvotes,0,1,0,1
DeWitt,401,United States Senator,,Democratic Party,Victor Hugo Harris,3,0,1,4
DeWitt,401,United States Senator,,Democratic Party,"Annie ""Mam√°"" Garcia",13,1,4,18
DeWitt,401,United States Senator,,Democratic Party,Amanda K. Edwards,6,0,4,10
DeWitt,401,United States Senator,,Democratic Party,Royce West,3,1,4,8
DeWitt,401,United States Senator,,Democratic Party,Adrian Ocegueda,3,0,2,5
DeWitt,401,United States Senator,,Democratic Party,D.R. Hunter,2,0,0,2
DeWitt,401,United States Senator,,Democratic Party,Michael Cooper,8,0,2,10
DeWitt,401,United States Senator,,Democratic Party,Chris Bell,5,3,5,13
DeWitt,401,United States Senator,,Democratic Party,Cristina Tzintzun Ramirez,4,2,2,8
DeWitt,401,United States Senator,,Democratic Party,Sema Hernandez,0,0,0,0
DeWitt,401,United States Senator,,Democratic Party,Jack Daniel Foster Jr,0,1,0,1
DeWitt,401,United States Senator,,Democratic Party,"Mary ""MJ"" Hegar",3,7,10,20
DeWitt,401,Ballots Cast,,Democratic Party,,50,15,34,99
DeWitt,401,United States Senator,,Democratic Party,Undervotes,8,4,3,15
DeWitt,401,United States Senator,,Democratic Party,Overvotes,0,1,0,1
DeWitt,401,"United States Representative, District No. 34",,Democratic Party,Diego Zavala,23,1,8,32
DeWitt,401,"United States Representative, District No. 34",,Democratic Party,Osbert Haro,3,1,0,4
DeWitt,401,"United States Representative, District No. 34",,Democratic Party,Filemon B. Vela,26,15,26,67
DeWitt,401,Ballots Cast,,Democratic Party,,52,17,34,103
DeWitt,401,"United States Representative, District No. 34",,Democratic Party,Undervotes,6,3,3,12
DeWitt,401,"United States Representative, District No. 34",,Democratic Party,Overvotes,0,0,0,0
DeWitt,401,Railroad Commissioner,,Democratic Party,Chrysta Casta√±eda,14,4,9,27
DeWitt,401,Railroad Commissioner,,Democratic Party,Kelly Stone,11,4,10,25
DeWitt,401,Railroad Commissioner,,Democratic Party,Mark Watson,12,6,8,26
DeWitt,401,Railroad Commissioner,,Democratic Party,"Roberto R. ""Beto"" Alonzo",16,3,7,26
DeWitt,401,Ballots Cast,,Democratic Party,,53,17,34,104
DeWitt,401,Railroad Commissioner,,Democratic Party,Undervotes,5,3,3,11
DeWitt,401,Railroad Commissioner,,Democratic Party,Overvotes,0,0,0,0
DeWitt,401,"Chief Justice, Supreme Court",,Democratic Party,Jerry Zimmerer,12,5,7,24
DeWitt,401,"Chief Justice, Supreme Court",,Democratic Party,Amy Clark Meachum,41,12,27,80
DeWitt,401,Ballots Cast,,Democratic Party,,53,17,34,104
DeWitt,401,"Chief Justice, Supreme Court",,Democratic Party,Undervotes,5,3,3,11
DeWitt,401,"Chief Justice, Supreme Court",,Democratic Party,Overvotes,0,0,0,0
DeWitt,401,"Justice, Supreme Court, Place 6 Unexpired Term",,Democratic Party,Larry Praeger,13,5,10,28
DeWitt,401,"Justice, Supreme Court, Place 6 Unexpired Term",,Democratic Party,Kathy Cheng,37,12,24,73
DeWitt,401,Ballots Cast,,Democratic Party,,50,17,34,101
DeWitt,401,"Justice, Supreme Court, Place 6 Unexpired Term",,Democratic Party,Undervotes,8,3,3,14
DeWitt,401,"Justice, Supreme Court, Place 6 Unexpired Term",,Democratic Party,Overvotes,0,0,0,0
DeWitt,401,"Justice, Supreme Court, Place 7",,Democratic Party,Staci Williams,36,11,19,66
DeWitt,401,"Justice, Supreme Court, Place 7",,Democratic Party,Brandy Voss,15,6,14,35
DeWitt,401,Ballots Cast,,Democratic Party,,51,17,33,101
DeWitt,401,"Justice, Supreme Court, Place 7",,Democratic Party,Undervotes,7,3,4,14
DeWitt,401,"Justice, Supreme Court, Place 7",,Democratic Party,Overvotes,0,0,0,0
DeWitt,401,"Justice, Supreme Court, Place 8",,Democratic Party,Peter Kelly,14,6,13,33
DeWitt,401,"Justice, Supreme Court, Place 8",,Democratic Party,Gisela D. Triana,36,10,19,65
DeWitt,401,Ballots Cast,,Democratic Party,,50,16,32,98
DeWitt,401,"Justice, Supreme Court, Place 8",,Democratic Party,Undervotes,8,4,5,17
DeWitt,401,"Justice, Supreme Court, Place 8",,Democratic Party,Overvotes,0,0,0,0
DeWitt,401,"Judge, Court of Criminal Appeals, Place 3",,Democratic Party,Dan Wood,11,4,6,21
DeWitt,401,"Judge, Court of Criminal Appeals, Place 3",,Democratic Party,William Pieratt Demond,3,1,1,5
DeWitt,401,"Judge, Court of Criminal Appeals, Place 3",,Democratic Party,Elizabeth Davis Frizell,37,12,27,76
DeWitt,401,Ballots Cast,,Democratic Party,,51,17,34,102
DeWitt,401,"Judge, Court of Criminal Appeals, Place 3",,Democratic Party,Undervotes,7,3,3,13
DeWitt,401,"Judge, Court of Criminal Appeals, Place 3",,Democratic Party,Overvotes,0,0,0,0
DeWitt,401,"Judge, Court of Criminal Appeals, Place 4",,Democratic Party,Steven Miears,12,8,10,30
DeWitt,401,"Judge, Court of Criminal Appeals, Place 4",,Democratic Party,Tina Clinton,40,9,24,73
DeWitt,401,Ballots Cast,,Democratic Party,,52,17,34,103
DeWitt,401,"Judge, Court of Criminal Appeals, Place 4",,Democratic Party,Undervotes,6,3,3,12
DeWitt,401,"Judge, Court of Criminal Appeals, Place 4",,Democratic Party,Overvotes,0,0,0,0
DeWitt,401,"Judge, Court of Criminal Appeals, Place 9",,Democratic Party,Brandon Birmingham,45,15,30,90
DeWitt,401,Ballots Cast,,Democratic Party,,45,15,30,90
DeWitt,401,"Judge, Court of Criminal Appeals, Place 9",,Democratic Party,Undervotes,13,5,7,25
DeWitt,401,"Judge, Court of Criminal Appeals, Place 9",,Democratic Party,Overvotes,0,0,0,0
DeWitt,401,"State Senator, District 18",,Democratic Party,Michael Antalan,48,15,29,92
DeWitt,401,Ballots Cast,,Democratic Party,,48,15,29,92
DeWitt,401,"State Senator, District 18",,Democratic Party,Undervotes,10,5,8,23
DeWitt,401,"State Senator, District 18",,Democratic Party,Overvotes,0,0,0,0
DeWitt,401,County Chairman,,Democratic Party,Jospeh L. Sheppard,52,16,33,101
DeWitt,401,Ballots Cast,,Democratic Party,,52,16,33,101
DeWitt,401,County Chairman,,Democratic Party,Undervotes,6,4,4,14
DeWitt,401,County Chairman,,Democratic Party,Overvotes,0,0,0,0
DeWitt,401,President,,Republican Party,Zoltan G. Istvan,2,0,0,2
DeWitt,401,President,,Republican Party,Donald J. Trump,238,53,312,603
DeWitt,401,President,,Republican Party,Bill Weld,2,1,4,7
DeWitt,401,President,,Republican Party,Joe Walsh,2,0,2,4
DeWitt,401,President,,Republican Party,"Roque ""Rocky"" De La Fuente Guerra",1,0,0,1
DeWitt,401,President,,Republican Party,Matthew John Matern,0,0,0,0
DeWitt,401,President,,Republican Party,Bob Ely,0,0,0,0
DeWitt,401,President,,Republican Party,Uncommitted,12,2,9,23
DeWitt,401,Ballots Cast,,Republican Party,,257,56,327,640
DeWitt,401,President,,Republican Party,Undervotes,2,1,2,5
DeWitt,401,President,,Republican Party,Overvotes,0,0,0,0
DeWitt,401,United States Senator,,Republican Party,Dwayne Stovall,58,12,75,145
DeWitt,401,United States Senator,,Republican Party,Mark Yancey,14,2,22,38
DeWitt,401,United States Senator,,Republican Party,Virgil Bierschwale,2,0,1,3
DeWitt,401,United States Senator,,Republican Party,John Cornyn,155,40,203,398
DeWitt,401,United States Senator,,Republican Party,John Anthony Castro,10,0,2,12
DeWitt,401,Ballots Cast,,Republican Party,,239,54,303,596
DeWitt,401,United States Senator,,Republican Party,Undervotes,20,2,26,48
DeWitt,401,United States Senator,,Republican Party,Overvotes,0,1,0,1
DeWitt,401,"United States Representative, District No. 34",,Republican Party,Rey Gonzalez,138,28,164,330
DeWitt,401,"United States Representative, District No. 34",,Republican Party,Rod Lingsch,82,21,111,214
DeWitt,401,Ballots Cast,,Republican Party,,220,49,275,544
DeWitt,401,"United States Representative, District No. 34",,Republican Party,Undervotes,39,8,54,101
DeWitt,401,"United States Representative, District No. 34",,Republican Party,Overvotes,0,0,0,0
DeWitt,401,Railroad Commissioner,,Republican Party,Ryan Sitton,67,19,101,187
DeWitt,401,Railroad Commissioner,,Republican Party,"James ""Jim"" Wright",148,32,171,351
DeWitt,401,Ballots Cast,,Republican Party,,215,51,272,538
DeWitt,401,Railroad Commissioner,,Republican Party,Undervotes,44,6,57,107
DeWitt,401,Railroad Commissioner,,Republican Party,Overvotes,0,0,0,0
DeWitt,401,"Chief Justice, Supreme Court",,Republican Party,Nathan Hecht,224,48,268,540
DeWitt,401,Ballots Cast,,Republican Party,,224,48,268,540
DeWitt,401,"Chief Justice, Supreme Court",,Republican Party,Undervotes,35,9,61,105
DeWitt,401,"Chief Justice, Supreme Court",,Republican Party,Overvotes,0,0,0,0
DeWitt,401,"Justice, Supreme Court, Place 6 Unexpired Term",,Republican Party,Jane Bland,221,49,272,542
DeWitt,401,Ballots Cast,,Republican Party,,221,49,272,542
DeWitt,401,"Justice, Supreme Court, Place 6 Unexpired Term",,Republican Party,Undervotes,38,8,57,103
DeWitt,401,"Justice, Supreme Court, Place 6 Unexpired Term",,Republican Party,Overvotes,0,0,0,0
DeWitt,401,"Justice, Supreme Court, Place 7",,Republican Party,Jeff Boyd,220,49,272,541
DeWitt,401,Ballots Cast,,Republican Party,,220,49,272,541
DeWitt,401,"Justice, Supreme Court, Place 7",,Republican Party,Undervotes,39,8,57,104
DeWitt,401,"Justice, Supreme Court, Place 7",,Republican Party,Overvotes,0,0,0,0
DeWitt,401,"Justice, Supreme Court, Place 8",,Republican Party,Brett Busby,217,49,269,535
DeWitt,401,Ballots Cast,,Republican Party,,217,49,269,535
DeWitt,401,"Justice, Supreme Court, Place 8",,Republican Party,Undervotes,42,8,60,110
DeWitt,401,"Justice, Supreme Court, Place 8",,Republican Party,Overvotes,0,0,0,0
DeWitt,401,"Judge, Court of Criminal Appeals, Place 3",,Republican Party,Gina Parker,127,29,150,306
DeWitt,401,"Judge, Court of Criminal Appeals, Place 3",,Republican Party,Bert Richardson,86,19,113,218
DeWitt,401,Ballots Cast,,Republican Party,,213,48,263,524
DeWitt,401,"Judge, Court of Criminal Appeals, Place 3",,Republican Party,Undervotes,46,8,66,120
DeWitt,401,"Judge, Court of Criminal Appeals, Place 3",,Republican Party,Overvotes,0,1,0,1
DeWitt,401,"Judge, Court of Criminal Appeals, Place 4",,Republican Party,Kevin Patrick Yeary,214,49,269,532
DeWitt,401,Ballots Cast,,Republican Party,,214,49,269,532
DeWitt,401,"Judge, Court of Criminal Appeals, Place 4",,Republican Party,Undervotes,45,8,60,113
DeWitt,401,"Judge, Court of Criminal Appeals, Place 4",,Republican Party,Overvotes,0,0,0,0
DeWitt,401,"Judge, Court of Criminal Appeals, Place 9",,Republican Party,David Newell,211,49,271,531
DeWitt,401,Ballots Cast,,Republican Party,,211,49,271,531
DeWitt,401,"Judge, Court of Criminal Appeals, Place 9",,Republican Party,Undervotes,48,8,58,114
DeWitt,401,"Judge, Court of Criminal Appeals, Place 9",,Republican Party,Overvotes,0,0,0,0
DeWitt,401,"State Senator, District 18",,Republican Party,Lois W. Kolkhorst,231,49,290,570
DeWitt,401,Ballots Cast,,Republican Party,,231,49,290,570
DeWitt,401,"State Senator, District 18",,Republican Party,Undervotes,28,8,39,75
DeWitt,401,"State Senator, District 18",,Republican Party,Overvotes,0,0,0,0
DeWitt,401,"State Representative, District 30",,Republican Party,Geanie W. Morrison,199,44,263,506
DeWitt,401,"State Representative, District 30",,Republican Party,Vanessa Hicks-Callaway,45,10,45,100
DeWitt,401,Ballots Cast,,Republican Party,,244,54,308,606
DeWitt,401,"State Representative, District 30",,Republican Party,Undervotes,15,3,21,39
DeWitt,401,"State Representative, District 30",,Republican Party,Overvotes,0,0,0,0
DeWitt,401,"District Attorney, 24th Judicial District",,Republican Party,"Robert C. ""Rob"" Lassman",219,50,297,566
DeWitt,401,Ballots Cast,,Republican Party,,219,50,297,566
DeWitt,401,"District Attorney, 24th Judicial District",,Republican Party,Undervotes,40,7,32,79
DeWitt,401,"District Attorney, 24th Judicial District",,Republican Party,Overvotes,0,0,0,0
DeWitt,401,County Attorney,,Republican Party,Jay Condie,224,50,291,565
DeWitt,401,Ballots Cast,,Republican Party,,224,50,291,565
DeWitt,401,County Attorney,,Republican Party,Undervotes,35,7,38,80
DeWitt,401,County Attorney,,Republican Party,Overvotes,0,0,0,0
DeWitt,401,Sheriff,,Republican Party,Carl R. Bowen,232,52,297,581
DeWitt,401,Ballots Cast,,Republican Party,,232,52,297,581
DeWitt,401,Sheriff,,Republican Party,Undervotes,27,5,32,64
DeWitt,401,Sheriff,,Republican Party,Overvotes,0,0,0,0
DeWitt,401,County Tax Assessor-Collector,,Republican Party,Ashley D. Mraz,189,44,256,489
DeWitt,401,County Tax Assessor-Collector,,Republican Party,Guy Dolan,64,12,67,143
DeWitt,401,Ballots Cast,,Republican Party,,253,56,323,632
DeWitt,401,County Tax Assessor-Collector,,Republican Party,Undervotes,6,1,6,13
DeWitt,401,County Tax Assessor-Collector,,Republican Party,Overvotes,0,0,0,0
DeWitt,401,"Constable, Precinct 2",,Republican Party,Jefferson Hobbs,164,40,202,406
DeWitt,401,"Constable, Precinct 2",,Republican Party,Jeff Abbott,75,14,102,191
DeWitt,401,Ballots Cast,,Republican Party,,239,54,304,597
DeWitt,401,"Constable, Precinct 2",,Republican Party,Undervotes,20,2,25,47
DeWitt,401,"Constable, Precinct 2",,Republican Party,Overvotes,0,1,0,1
DeWitt,401,County Chairman,,Republican Party,Paul Guidry,224,50,285,559
DeWitt,401,Ballots Cast,,Republican Party,,224,50,285,559
DeWitt,401,County Chairman,,Republican Party,Undervotes,35,7,44,86
DeWitt,401,County Chairman,,Republican Party,Overvotes,0,0,0,0
DeWitt,401,Proposition #1,,Democratic Party,Yes,53,16,32,101
DeWitt,401,Proposition #1,,Democratic Party,No,1,3,2,6
DeWitt,401,Ballots Cast,,Democratic Party,,54,19,34,107
DeWitt,401,Proposition #1,,Democratic Party,Undervotes,4,1,3,8
DeWitt,401,Proposition #1,,Democratic Party,Overvotes,0,0,0,0
DeWitt,401,Proposition #2,,Democratic Party,Yes,55,18,30,103
DeWitt,401,Proposition #2,,Democratic Party,No,2,1,3,6
DeWitt,401,Ballots Cast,,Democratic Party,,57,19,33,109
DeWitt,401,Proposition #2,,Democratic Party,Undervotes,1,1,4,6
DeWitt,401,Proposition #2,,Democratic Party,Overvotes,0,0,0,0
DeWitt,401,Proposition #3,,Democratic Party,Yes,57,18,35,110
DeWitt,401,Proposition #3,,Democratic Party,No,0,1,0,1
DeWitt,401,Ballots Cast,,Democratic Party,,57,19,35,111
DeWitt,401,Proposition #3,,Democratic Party,Undervotes,1,1,2,4
DeWitt,401,Proposition #3,,Democratic Party,Overvotes,0,0,0,0
DeWitt,401,Proposition #4,,Democratic Party,Yes,56,16,34,106
DeWitt,401,Proposition #4,,Democratic Party,No,1,3,1,5
DeWitt,401,Ballots Cast,,Democratic Party,,57,19,35,111
DeWitt,401,Proposition #4,,Democratic Party,Undervotes,1,1,2,4
DeWitt,401,Proposition #4,,Democratic Party,Overvotes,0,0,0,0
DeWitt,401,Proposition #5,,Democratic Party,Yes,55,17,34,106
DeWitt,401,Proposition #5,,Democratic Party,No,2,2,1,5
DeWitt,401,Ballots Cast,,Democratic Party,,57,19,35,111
DeWitt,401,Proposition #5,,Democratic Party,Undervotes,1,1,2,4
DeWitt,401,Proposition #5,,Democratic Party,Overvotes,0,0,0,0
DeWitt,401,Proposition #6,,Democratic Party,Yes,57,17,34,108
DeWitt,401,Proposition #6,,Democratic Party,No,0,2,1,3
DeWitt,401,Ballots Cast,,Democratic Party,,57,19,35,111
DeWitt,401,Proposition #6,,Democratic Party,Undervotes,1,1,2,4
DeWitt,401,Proposition #6,,Democratic Party,Overvotes,0,0,0,0
DeWitt,401,Proposition #7,,Democratic Party,Yes,52,16,35,103
DeWitt,401,Proposition #7,,Democratic Party,No,2,3,0,5
DeWitt,401,Ballots Cast,,Democratic Party,,54,19,35,108
DeWitt,401,Proposition #7,,Democratic Party,Undervotes,4,1,2,7
DeWitt,401,Proposition #7,,Democratic Party,Overvotes,0,0,0,0
DeWitt,401,Proposition #8,,Democratic Party,Yes,53,17,34,104
DeWitt,401,Proposition #8,,Democratic Party,No,3,2,1,6
DeWitt,401,Ballots Cast,,Democratic Party,,56,19,35,110
DeWitt,401,Proposition #8,,Democratic Party,Undervotes,2,1,2,5
DeWitt,401,Proposition #8,,Democratic Party,Overvotes,0,0,0,0
DeWitt,401,Proposition #9,,Democratic Party,Yes,55,17,34,106
DeWitt,401,Proposition #9,,Democratic Party,No,0,2,1,3
DeWitt,401,Ballots Cast,,Democratic Party,,55,19,35,109
DeWitt,401,Proposition #9,,Democratic Party,Undervotes,3,1,2,6
DeWitt,401,Proposition #9,,Democratic Party,Overvotes,0,0,0,0
DeWitt,401,Proposition #10,,Democratic Party,Yes,53,16,34,103
DeWitt,401,Proposition #10,,Democratic Party,No,1,3,1,5
DeWitt,401,Ballots Cast,,Democratic Party,,54,19,35,108
DeWitt,401,Proposition #10,,Democratic Party,Undervotes,4,1,2,7
DeWitt,401,Proposition #10,,Democratic Party,Overvotes,0,0,0,0
DeWitt,401,Proposition #11,,Democratic Party,Yes,46,14,32,92
DeWitt,401,Proposition #11,,Democratic Party,No,2,5,2,9
DeWitt,401,Ballots Cast,,Democratic Party,,48,19,34,101
DeWitt,401,Proposition #11,,Democratic Party,Undervotes,10,1,3,14
DeWitt,401,Proposition #11,,Democratic Party,Overvotes,0,0,0,0
DeWitt,401,Proposition 1,,Republican Party,Yes,229,45,287,561
DeWitt,401,Proposition 1,,Republican Party,No,23,12,38,73
DeWitt,401,Ballots Cast,,Republican Party,,252,57,325,634
DeWitt,401,Proposition 1,,Republican Party,Undervotes,7,0,4,11
DeWitt,401,Proposition 1,,Republican Party,Overvotes,0,0,0,0
DeWitt,401,Proposition 2,,Republican Party,Yes,226,47,284,557
DeWitt,401,Proposition 2,,Republican Party,No,29,10,41,80
DeWitt,401,Ballots Cast,,Republican Party,,255,57,325,637
DeWitt,401,Proposition 2,,Republican Party,Undervotes,4,0,4,8
DeWitt,401,Proposition 2,,Republican Party,Overvotes,0,0,0,0
DeWitt,401,Proposition 3,,Republican Party,Yes,237,52,289,578
DeWitt,401,Proposition 3,,Republican Party,No,10,3,26,39
DeWitt,401,Ballots Cast,,Republican Party,,247,55,315,617
DeWitt,401,Proposition 3,,Republican Party,Undervotes,12,1,14,27
DeWitt,401,Proposition 3,,Republican Party,Overvotes,0,1,0,1
DeWitt,401,Proposition 4,,Republican Party,Yes,237,51,304,592
DeWitt,401,Proposition 4,,Republican Party,No,16,5,16,37
DeWitt,401,Ballots Cast,,Republican Party,,253,56,320,629
DeWitt,401,Proposition 4,,Republican Party,Undervotes,6,1,9,16
DeWitt,401,Proposition 4,,Republican Party,Overvotes,0,0,0,0
DeWitt,401,Proposition 5,,Republican Party,Yes,225,49,296,570
DeWitt,401,Proposition 5,,Republican Party,No,29,5,22,56
DeWitt,401,Ballots Cast,,Republican Party,,254,54,318,626
DeWitt,401,Proposition 5,,Republican Party,Undervotes,5,3,11,19
DeWitt,401,Proposition 5,,Republican Party,Overvotes,0,0,0,0
DeWitt,401,Proposition 6,,Republican Party,Yes,243,51,293,587
DeWitt,401,Proposition 6,,Republican Party,No,8,2,17,27
DeWitt,401,Ballots Cast,,Republican Party,,251,53,310,614
DeWitt,401,Proposition 6,,Republican Party,Undervotes,8,4,19,31
DeWitt,401,Proposition 6,,Republican Party,Overvotes,0,0,0,0
DeWitt,401,Proposition 7,,Republican Party,Yes,251,52,314,617
DeWitt,401,Proposition 7,,Republican Party,No,2,1,4,7
DeWitt,401,Ballots Cast,,Republican Party,,253,53,318,624
DeWitt,401,Proposition 7,,Republican Party,Undervotes,6,4,11,21
DeWitt,401,Proposition 7,,Republican Party,Overvotes,0,0,0,0
DeWitt,401,Proposition 8,,Republican Party,Yes,252,52,312,616
DeWitt,401,Proposition 8,,Republican Party,No,1,0,5,6
DeWitt,401,Ballots Cast,,Republican Party,,253,52,317,622
DeWitt,401,Proposition 8,,Republican Party,Undervotes,6,4,12,22
DeWitt,401,Proposition 8,,Republican Party,Overvotes,0,1,0,1
DeWitt,401,Proposition 9,,Republican Party,Yes,238,51,304,593
DeWitt,401,Proposition 9,,Republican Party,No,14,1,11,26
DeWitt,401,Ballots Cast,,Republican Party,,252,52,315,619
DeWitt,401,Proposition 9,,Republican Party,Undervotes,7,4,14,25
DeWitt,401,Proposition 9,,Republican Party,Overvotes,0,1,0,1
DeWitt,401,Proposition 10,,Republican Party,Yes,233,52,291,576
DeWitt,401,Proposition 10,,Republican Party,No,15,1,22,38
DeWitt,401,Ballots Cast,,Republican Party,,248,53,313,614
DeWitt,401,Proposition 10,,Republican Party,Undervotes,11,4,16,31
DeWitt,401,Proposition 10,,Republican Party,Overvotes,0,0,0,0
DeWitt,402,President,,Democratic Party,Amy Klobuchar,0,1,0,1
DeWitt,402,President,,Democratic Party,Joseph R. Biden,7,4,2,13
DeWitt,402,President,,Democratic Party,Michael Bennet,0,0,0,0
DeWitt,402,President,,Democratic Party,Marianne Williamson,0,0,0,0
DeWitt,402,President,,Democratic Party,Michael R. Bloomberg,0,2,2,4
DeWitt,402,President,,Democratic Party,Elizabeth Warren,3,2,2,7
DeWitt,402,President,,Democratic Party,Andrew Yang,0,0,0,0
DeWitt,402,President,,Democratic Party,Tom Steyer,0,0,0,0
DeWitt,402,President,,Democratic Party,Pete Buttigieg,0,0,1,1
DeWitt,402,President,,Democratic Party,Tulsi Gabbard,0,0,0,0
DeWitt,402,President,,Democratic Party,Robby Wells,0,0,0,0
DeWitt,402,President,,Democratic Party,Deval Patrick,0,0,0,0
DeWitt,402,President,,Democratic Party,Bernie Sanders,4,0,3,7
DeWitt,402,President,,Democratic Party,"Roque ""Rocky"" De La Fuente Guerra",0,0,0,0
DeWitt,402,President,,Democratic Party,John K. Delaney,0,0,0,0
DeWitt,402,President,,Democratic Party,Cory Booker,0,0,0,0
DeWitt,402,President,,Democratic Party,Juli√°n Castro,0,0,0,0
DeWitt,402,Ballots Cast,,Democratic Party,,14,9,10,33
DeWitt,402,President,,Democratic Party,Undervotes,1,0,0,1
DeWitt,402,President,,Democratic Party,Overvotes,0,0,0,0
DeWitt,402,United States Senator,,Democratic Party,Victor Hugo Harris,2,0,1,3
DeWitt,402,United States Senator,,Democratic Party,"Annie ""Mam√°"" Garcia",2,2,1,5
DeWitt,402,United States Senator,,Democratic Party,Amanda K. Edwards,1,2,0,3
DeWitt,402,United States Senator,,Democratic Party,Royce West,0,0,1,1
DeWitt,402,United States Senator,,Democratic Party,Adrian Ocegueda,0,0,0,0
DeWitt,402,United States Senator,,Democratic Party,D.R. Hunter,2,0,0,2
DeWitt,402,United States Senator,,Democratic Party,Michael Cooper,0,1,0,1
DeWitt,402,United States Senator,,Democratic Party,Chris Bell,0,0,2,2
DeWitt,402,United States Senator,,Democratic Party,Cristina Tzintzun Ramirez,0,0,0,0
DeWitt,402,United States Senator,,Democratic Party,Sema Hernandez,0,1,2,3
DeWitt,402,United States Senator,,Democratic Party,Jack Daniel Foster Jr,0,0,0,0
DeWitt,402,United States Senator,,Democratic Party,"Mary ""MJ"" Hegar",3,3,1,7
DeWitt,402,Ballots Cast,,Democratic Party,,10,9,8,27
DeWitt,402,United States Senator,,Democratic Party,Undervotes,5,0,2,7
DeWitt,402,United States Senator,,Democratic Party,Overvotes,0,0,0,0
DeWitt,402,"United States Representative, District No. 34",,Democratic Party,Diego Zavala,1,2,2,5
DeWitt,402,"United States Representative, District No. 34",,Democratic Party,Osbert Haro,1,1,3,5
DeWitt,402,"United States Representative, District No. 34",,Democratic Party,Filemon B. Vela,8,6,4,18
DeWitt,402,Ballots Cast,,Democratic Party,,10,9,9,28
DeWitt,402,"United States Representative, District No. 34",,Democratic Party,Undervotes,5,0,1,6
DeWitt,402,"United States Representative, District No. 34",,Democratic Party,Overvotes,0,0,0,0
DeWitt,402,Railroad Commissioner,,Democratic Party,Chrysta Casta√±eda,3,2,2,7
DeWitt,402,Railroad Commissioner,,Democratic Party,Kelly Stone,1,0,4,5
DeWitt,402,Railroad Commissioner,,Democratic Party,Mark Watson,6,2,3,11
DeWitt,402,Railroad Commissioner,,Democratic Party,"Roberto R. ""Beto"" Alonzo",2,3,0,5
DeWitt,402,Ballots Cast,,Democratic Party,,12,7,9,28
DeWitt,402,Railroad Commissioner,,Democratic Party,Undervotes,3,2,1,6
DeWitt,402,Railroad Commissioner,,Democratic Party,Overvotes,0,0,0,0
DeWitt,402,"Chief Justice, Supreme Court",,Democratic Party,Jerry Zimmerer,1,2,2,5
DeWitt,402,"Chief Justice, Supreme Court",,Democratic Party,Amy Clark Meachum,9,5,7,21
DeWitt,402,Ballots Cast,,Democratic Party,,10,7,9,26
DeWitt,402,"Chief Justice, Supreme Court",,Democratic Party,Undervotes,5,2,1,8
DeWitt,402,"Chief Justice, Supreme Court",,Democratic Party,Overvotes,0,0,0,0
DeWitt,402,"Justice, Supreme Court, Place 6 Unexpired Term",,Democratic Party,Larry Praeger,5,3,3,11
DeWitt,402,"Justice, Supreme Court, Place 6 Unexpired Term",,Democratic Party,Kathy Cheng,6,6,5,17
DeWitt,402,Ballots Cast,,Democratic Party,,11,9,8,28
DeWitt,402,"Justice, Supreme Court, Place 6 Unexpired Term",,Democratic Party,Undervotes,4,0,2,6
DeWitt,402,"Justice, Supreme Court, Place 6 Unexpired Term",,Democratic Party,Overvotes,0,0,0,0
DeWitt,402,"Justice, Supreme Court, Place 7",,Democratic Party,Staci Williams,8,3,7,18
DeWitt,402,"Justice, Supreme Court, Place 7",,Democratic Party,Brandy Voss,3,4,1,8
DeWitt,402,Ballots Cast,,Democratic Party,,11,7,8,26
DeWitt,402,"Justice, Supreme Court, Place 7",,Democratic Party,Undervotes,4,2,2,8
DeWitt,402,"Justice, Supreme Court, Place 7",,Democratic Party,Overvotes,0,0,0,0
DeWitt,402,"Justice, Supreme Court, Place 8",,Democratic Party,Peter Kelly,7,4,5,16
DeWitt,402,"Justice, Supreme Court, Place 8",,Democratic Party,Gisela D. Triana,3,3,3,9
DeWitt,402,Ballots Cast,,Democratic Party,,10,7,8,25
DeWitt,402,"Justice, Supreme Court, Place 8",,Democratic Party,Undervotes,5,2,2,9
DeWitt,402,"Justice, Supreme Court, Place 8",,Democratic Party,Overvotes,0,0,0,0
DeWitt,402,"Judge, Court of Criminal Appeals, Place 3",,Democratic Party,Dan Wood,4,1,1,6
DeWitt,402,"Judge, Court of Criminal Appeals, Place 3",,Democratic Party,William Pieratt Demond,1,1,1,3
DeWitt,402,"Judge, Court of Criminal Appeals, Place 3",,Democratic Party,Elizabeth Davis Frizell,6,5,6,17
DeWitt,402,Ballots Cast,,Democratic Party,,11,7,8,26
DeWitt,402,"Judge, Court of Criminal Appeals, Place 3",,Democratic Party,Undervotes,4,2,2,8
DeWitt,402,"Judge, Court of Criminal Appeals, Place 3",,Democratic Party,Overvotes,0,0,0,0
DeWitt,402,"Judge, Court of Criminal Appeals, Place 4",,Democratic Party,Steven Miears,7,1,3,11
DeWitt,402,"Judge, Court of Criminal Appeals, Place 4",,Democratic Party,Tina Clinton,4,6,5,15
DeWitt,402,Ballots Cast,,Democratic Party,,11,7,8,26
DeWitt,402,"Judge, Court of Criminal Appeals, Place 4",,Democratic Party,Undervotes,4,2,2,8
DeWitt,402,"Judge, Court of Criminal Appeals, Place 4",,Democratic Party,Overvotes,0,0,0,0
DeWitt,402,"Judge, Court of Criminal Appeals, Place 9",,Democratic Party,Brandon Birmingham,11,9,7,27
DeWitt,402,Ballots Cast,,Democratic Party,,11,9,7,27
DeWitt,402,"Judge, Court of Criminal Appeals, Place 9",,Democratic Party,Undervotes,4,0,3,7
DeWitt,402,"Judge, Court of Criminal Appeals, Place 9",,Democratic Party,Overvotes,0,0,0,0
DeWitt,402,"State Senator, District 18",,Democratic Party,Michael Antalan,11,9,6,26
DeWitt,402,Ballots Cast,,Democratic Party,,11,9,6,26
DeWitt,402,"State Senator, District 18",,Democratic Party,Undervotes,4,0,4,8
DeWitt,402,"State Senator, District 18",,Democratic Party,Overvotes,0,0,0,0
DeWitt,402,County Chairman,,Democratic Party,Jospeh L. Sheppard,11,9,6,26
DeWitt,402,Ballots Cast,,Democratic Party,,11,9,6,26
DeWitt,402,County Chairman,,Democratic Party,Undervotes,4,0,4,8
DeWitt,402,County Chairman,,Democratic Party,Overvotes,0,0,0,0
DeWitt,402,President,,Republican Party,Zoltan G. Istvan,0,0,0,0
DeWitt,402,President,,Republican Party,Donald J. Trump,182,29,147,358
DeWitt,402,President,,Republican Party,Bill Weld,1,0,0,1
DeWitt,402,President,,Republican Party,Joe Walsh,1,0,0,1
DeWitt,402,President,,Republican Party,"Roque ""Rocky"" De La Fuente Guerra",0,0,0,0
DeWitt,402,President,,Republican Party,Matthew John Matern,0,0,0,0
DeWitt,402,President,,Republican Party,Bob Ely,0,0,0,0
DeWitt,402,President,,Republican Party,Uncommitted,2,2,3,7
DeWitt,402,Ballots Cast,,Republican Party,,186,31,150,367
DeWitt,402,President,,Republican Party,Undervotes,2,0,0,2
DeWitt,402,President,,Republican Party,Overvotes,0,0,0,0
DeWitt,402,United States Senator,,Republican Party,Dwayne Stovall,43,8,29,80
DeWitt,402,United States Senator,,Republican Party,Mark Yancey,11,0,9,20
DeWitt,402,United States Senator,,Republican Party,Virgil Bierschwale,1,0,0,1
DeWitt,402,United States Senator,,Republican Party,John Cornyn,115,23,103,241
DeWitt,402,United States Senator,,Republican Party,John Anthony Castro,4,0,2,6
DeWitt,402,Ballots Cast,,Republican Party,,174,31,143,348
DeWitt,402,United States Senator,,Republican Party,Undervotes,14,0,7,21
DeWitt,402,United States Senator,,Republican Party,Overvotes,0,0,0,0
DeWitt,402,"United States Representative, District No. 34",,Republican Party,Rey Gonzalez,81,19,75,175
DeWitt,402,"United States Representative, District No. 34",,Republican Party,Rod Lingsch,84,7,55,146
DeWitt,402,Ballots Cast,,Republican Party,,165,26,130,321
DeWitt,402,"United States Representative, District No. 34",,Republican Party,Undervotes,23,5,20,48
DeWitt,402,"United States Representative, District No. 34",,Republican Party,Overvotes,0,0,0,0
DeWitt,402,Railroad Commissioner,,Republican Party,Ryan Sitton,78,10,53,141
DeWitt,402,Railroad Commissioner,,Republican Party,"James ""Jim"" Wright",88,16,81,185
DeWitt,402,Ballots Cast,,Republican Party,,166,26,134,326
DeWitt,402,Railroad Commissioner,,Republican Party,Undervotes,22,5,16,43
DeWitt,402,Railroad Commissioner,,Republican Party,Overvotes,0,0,0,0
DeWitt,402,"Chief Justice, Supreme Court",,Republican Party,Nathan Hecht,155,28,133,316
DeWitt,402,Ballots Cast,,Republican Party,,155,28,133,316
DeWitt,402,"Chief Justice, Supreme Court",,Republican Party,Undervotes,33,3,17,53
DeWitt,402,"Chief Justice, Supreme Court",,Republican Party,Overvotes,0,0,0,0
DeWitt,402,"Justice, Supreme Court, Place 6 Unexpired Term",,Republican Party,Jane Bland,150,30,130,310
DeWitt,402,Ballots Cast,,Republican Party,,150,30,130,310
DeWitt,402,"Justice, Supreme Court, Place 6 Unexpired Term",,Republican Party,Undervotes,38,1,20,59
DeWitt,402,"Justice, Supreme Court, Place 6 Unexpired Term",,Republican Party,Overvotes,0,0,0,0
DeWitt,402,"Justice, Supreme Court, Place 7",,Republican Party,Jeff Boyd,153,30,133,316
DeWitt,402,Ballots Cast,,Republican Party,,153,30,133,316
DeWitt,402,"Justice, Supreme Court, Place 7",,Republican Party,Undervotes,35,1,17,53
DeWitt,402,"Justice, Supreme Court, Place 7",,Republican Party,Overvotes,0,0,0,0
DeWitt,402,"Justice, Supreme Court, Place 8",,Republican Party,Brett Busby,151,29,130,310
DeWitt,402,Ballots Cast,,Republican Party,,151,29,130,310
DeWitt,402,"Justice, Supreme Court, Place 8",,Republican Party,Undervotes,37,2,20,59
DeWitt,402,"Justice, Supreme Court, Place 8",,Republican Party,Overvotes,0,0,0,0
DeWitt,402,"Judge, Court of Criminal Appeals, Place 3",,Republican Party,Gina Parker,85,13,78,176
DeWitt,402,"Judge, Court of Criminal Appeals, Place 3",,Republican Party,Bert Richardson,75,15,56,146
DeWitt,402,Ballots Cast,,Republican Party,,160,28,134,322
DeWitt,402,"Judge, Court of Criminal Appeals, Place 3",,Republican Party,Undervotes,28,3,16,47
DeWitt,402,"Judge, Court of Criminal Appeals, Place 3",,Republican Party,Overvotes,0,0,0,0
DeWitt,402,"Judge, Court of Criminal Appeals, Place 4",,Republican Party,Kevin Patrick Yeary,150,29,130,309
DeWitt,402,Ballots Cast,,Republican Party,,150,29,130,309
DeWitt,402,"Judge, Court of Criminal Appeals, Place 4",,Republican Party,Undervotes,38,2,20,60
DeWitt,402,"Judge, Court of Criminal Appeals, Place 4",,Republican Party,Overvotes,0,0,0,0
DeWitt,402,"Judge, Court of Criminal Appeals, Place 9",,Republican Party,David Newell,149,29,130,308
DeWitt,402,Ballots Cast,,Republican Party,,149,29,130,308
DeWitt,402,"Judge, Court of Criminal Appeals, Place 9",,Republican Party,Undervotes,39,2,20,61
DeWitt,402,"Judge, Court of Criminal Appeals, Place 9",,Republican Party,Overvotes,0,0,0,0
DeWitt,402,"State Senator, District 18",,Republican Party,Lois W. Kolkhorst,160,30,141,331
DeWitt,402,Ballots Cast,,Republican Party,,160,30,141,331
DeWitt,402,"State Senator, District 18",,Republican Party,Undervotes,28,1,9,38
DeWitt,402,"State Senator, District 18",,Republican Party,Overvotes,0,0,0,0
DeWitt,402,"State Representative, District 30",,Republican Party,Geanie W. Morrison,143,29,122,294
DeWitt,402,"State Representative, District 30",,Republican Party,Vanessa Hicks-Callaway,32,2,26,60
DeWitt,402,Ballots Cast,,Republican Party,,175,31,148,354
DeWitt,402,"State Representative, District 30",,Republican Party,Undervotes,13,0,2,15
DeWitt,402,"State Representative, District 30",,Republican Party,Overvotes,0,0,0,0
DeWitt,402,"District Attorney, 24th Judicial District",,Republican Party,"Robert C. ""Rob"" Lassman",165,30,136,331
DeWitt,402,Ballots Cast,,Republican Party,,165,30,136,331
DeWitt,402,"District Attorney, 24th Judicial District",,Republican Party,Undervotes,23,1,14,38
DeWitt,402,"District Attorney, 24th Judicial District",,Republican Party,Overvotes,0,0,0,0
DeWitt,402,County Attorney,,Republican Party,Jay Condie,163,30,134,327
DeWitt,402,Ballots Cast,,Republican Party,,163,30,134,327
DeWitt,402,County Attorney,,Republican Party,Undervotes,25,1,16,42
DeWitt,402,County Attorney,,Republican Party,Overvotes,0,0,0,0
DeWitt,402,Sheriff,,Republican Party,Carl R. Bowen,167,30,138,335
DeWitt,402,Ballots Cast,,Republican Party,,167,30,138,335
DeWitt,402,Sheriff,,Republican Party,Undervotes,21,1,12,34
DeWitt,402,Sheriff,,Republican Party,Overvotes,0,0,0,0
DeWitt,402,County Tax Assessor-Collector,,Republican Party,Ashley D. Mraz,140,24,123,287
DeWitt,402,County Tax Assessor-Collector,,Republican Party,Guy Dolan,39,7,24,70
DeWitt,402,Ballots Cast,,Republican Party,,179,31,147,357
DeWitt,402,County Tax Assessor-Collector,,Republican Party,Undervotes,9,0,3,12
DeWitt,402,County Tax Assessor-Collector,,Republican Party,Overvotes,0,0,0,0
DeWitt,402,"Constable, Precinct 2",,Republican Party,Jefferson Hobbs,103,16,89,208
DeWitt,402,"Constable, Precinct 2",,Republican Party,Jeff Abbott,67,14,52,133
DeWitt,402,Ballots Cast,,Republican Party,,170,30,141,341
DeWitt,402,"Constable, Precinct 2",,Republican Party,Undervotes,18,1,9,28
DeWitt,402,"Constable, Precinct 2",,Republican Party,Overvotes,0,0,0,0
DeWitt,402,County Chairman,,Republican Party,Paul Guidry,158,30,134,322
DeWitt,402,Ballots Cast,,Republican Party,,158,30,134,322
DeWitt,402,County Chairman,,Republican Party,Undervotes,30,1,16,47
DeWitt,402,County Chairman,,Republican Party,Overvotes,0,0,0,0
DeWitt,402,Proposition #1,,Democratic Party,Yes,11,8,10,29
DeWitt,402,Proposition #1,,Democratic Party,No,3,1,0,4
DeWitt,402,Ballots Cast,,Democratic Party,,14,9,10,33
DeWitt,402,Proposition #1,,Democratic Party,Undervotes,1,0,0,1
DeWitt,402,Proposition #1,,Democratic Party,Overvotes,0,0,0,0
DeWitt,402,Proposition #2,,Democratic Party,Yes,12,9,10,31
DeWitt,402,Proposition #2,,Democratic Party,No,2,0,0,2
DeWitt,402,Ballots Cast,,Democratic Party,,14,9,10,33
DeWitt,402,Proposition #2,,Democratic Party,Undervotes,1,0,0,1
DeWitt,402,Proposition #2,,Democratic Party,Overvotes,0,0,0,0
DeWitt,402,Proposition #3,,Democratic Party,Yes,13,8,10,31
DeWitt,402,Proposition #3,,Democratic Party,No,1,1,0,2
DeWitt,402,Ballots Cast,,Democratic Party,,14,9,10,33
DeWitt,402,Proposition #3,,Democratic Party,Undervotes,1,0,0,1
DeWitt,402,Proposition #3,,Democratic Party,Overvotes,0,0,0,0
DeWitt,402,Proposition #4,,Democratic Party,Yes,13,9,10,32
DeWitt,402,Proposition #4,,Democratic Party,No,0,0,0,0
DeWitt,402,Ballots Cast,,Democratic Party,,13,9,10,32
DeWitt,402,Proposition #4,,Democratic Party,Undervotes,2,0,0,2
DeWitt,402,Proposition #4,,Democratic Party,Overvotes,0,0,0,0
DeWitt,402,Proposition #5,,Democratic Party,Yes,13,9,10,32
DeWitt,402,Proposition #5,,Democratic Party,No,0,0,0,0
DeWitt,402,Ballots Cast,,Democratic Party,,13,9,10,32
DeWitt,402,Proposition #5,,Democratic Party,Undervotes,2,0,0,2
DeWitt,402,Proposition #5,,Democratic Party,Overvotes,0,0,0,0
DeWitt,402,Proposition #6,,Democratic Party,Yes,14,9,10,33
DeWitt,402,Proposition #6,,Democratic Party,No,0,0,0,0
DeWitt,402,Ballots Cast,,Democratic Party,,14,9,10,33
DeWitt,402,Proposition #6,,Democratic Party,Undervotes,1,0,0,1
DeWitt,402,Proposition #6,,Democratic Party,Overvotes,0,0,0,0
DeWitt,402,Proposition #7,,Democratic Party,Yes,13,9,10,32
DeWitt,402,Proposition #7,,Democratic Party,No,1,0,0,1
DeWitt,402,Ballots Cast,,Democratic Party,,14,9,10,33
DeWitt,402,Proposition #7,,Democratic Party,Undervotes,1,0,0,1
DeWitt,402,Proposition #7,,Democratic Party,Overvotes,0,0,0,0
DeWitt,402,Proposition #8,,Democratic Party,Yes,12,8,10,30
DeWitt,402,Proposition #8,,Democratic Party,No,1,0,0,1
DeWitt,402,Ballots Cast,,Democratic Party,,13,8,10,31
DeWitt,402,Proposition #8,,Democratic Party,Undervotes,2,0,0,2
DeWitt,402,Proposition #8,,Democratic Party,Overvotes,0,1,0,1
DeWitt,402,Proposition #9,,Democratic Party,Yes,13,9,9,31
DeWitt,402,Proposition #9,,Democratic Party,No,0,0,1,1
DeWitt,402,Ballots Cast,,Democratic Party,,13,9,10,32
DeWitt,402,Proposition #9,,Democratic Party,Undervotes,2,0,0,2
DeWitt,402,Proposition #9,,Democratic Party,Overvotes,0,0,0,0
DeWitt,402,Proposition #10,,Democratic Party,Yes,13,9,10,32
DeWitt,402,Proposition #10,,Democratic Party,No,1,0,0,1
DeWitt,402,Ballots Cast,,Democratic Party,,14,9,10,33
DeWitt,402,Proposition #10,,Democratic Party,Undervotes,1,0,0,1
DeWitt,402,Proposition #10,,Democratic Party,Overvotes,0,0,0,0
DeWitt,402,Proposition #11,,Democratic Party,Yes,12,8,9,29
DeWitt,402,Proposition #11,,Democratic Party,No,0,1,1,2
DeWitt,402,Ballots Cast,,Democratic Party,,12,9,10,31
DeWitt,402,Proposition #11,,Democratic Party,Undervotes,3,0,0,3
DeWitt,402,Proposition #11,,Democratic Party,Overvotes,0,0,0,0
DeWitt,402,Proposition 1,,Republican Party,Yes,161,31,136,328
DeWitt,402,Proposition 1,,Republican Party,No,23,0,13,36
DeWitt,402,Ballots Cast,,Republican Party,,184,31,149,364
DeWitt,402,Proposition 1,,Republican Party,Undervotes,4,0,1,5
DeWitt,402,Proposition 1,,Republican Party,Overvotes,0,0,0,0
DeWitt,402,Proposition 2,,Republican Party,Yes,167,30,132,329
DeWitt,402,Proposition 2,,Republican Party,No,15,1,17,33
DeWitt,402,Ballots Cast,,Republican Party,,182,31,149,362
DeWitt,402,Proposition 2,,Republican Party,Undervotes,6,0,1,7
DeWitt,402,Proposition 2,,Republican Party,Overvotes,0,0,0,0
DeWitt,402,Proposition 3,,Republican Party,Yes,172,30,142,344
DeWitt,402,Proposition 3,,Republican Party,No,7,0,6,13
DeWitt,402,Ballots Cast,,Republican Party,,179,30,148,357
DeWitt,402,Proposition 3,,Republican Party,Undervotes,9,1,2,12
DeWitt,402,Proposition 3,,Republican Party,Overvotes,0,0,0,0
DeWitt,402,Proposition 4,,Republican Party,Yes,178,28,141,347
DeWitt,402,Proposition 4,,Republican Party,No,5,3,5,13
DeWitt,402,Ballots Cast,,Republican Party,,183,31,146,360
DeWitt,402,Proposition 4,,Republican Party,Undervotes,5,0,4,9
DeWitt,402,Proposition 4,,Republican Party,Overvotes,0,0,0,0
DeWitt,402,Proposition 5,,Republican Party,Yes,169,28,138,335
DeWitt,402,Proposition 5,,Republican Party,No,10,3,9,22
DeWitt,402,Ballots Cast,,Republican Party,,179,31,147,357
DeWitt,402,Proposition 5,,Republican Party,Undervotes,9,0,3,12
DeWitt,402,Proposition 5,,Republican Party,Overvotes,0,0,0,0
DeWitt,402,Proposition 6,,Republican Party,Yes,168,31,144,343
DeWitt,402,Proposition 6,,Republican Party,No,6,0,4,10
DeWitt,402,Ballots Cast,,Republican Party,,174,31,148,353
DeWitt,402,Proposition 6,,Republican Party,Undervotes,14,0,2,16
DeWitt,402,Proposition 6,,Republican Party,Overvotes,0,0,0,0
DeWitt,402,Proposition 7,,Republican Party,Yes,178,29,147,354
DeWitt,402,Proposition 7,,Republican Party,No,0,2,1,3
DeWitt,402,Ballots Cast,,Republican Party,,178,31,148,357
DeWitt,402,Proposition 7,,Republican Party,Undervotes,10,0,2,12
DeWitt,402,Proposition 7,,Republican Party,Overvotes,0,0,0,0
DeWitt,402,Proposition 8,,Republican Party,Yes,177,31,149,357
DeWitt,402,Proposition 8,,Republican Party,No,0,0,0,0
DeWitt,402,Ballots Cast,,Republican Party,,177,31,149,357
DeWitt,402,Proposition 8,,Republican Party,Undervotes,11,0,1,12
DeWitt,402,Proposition 8,,Republican Party,Overvotes,0,0,0,0
DeWitt,402,Proposition 9,,Republican Party,Yes,175,31,143,349
DeWitt,402,Proposition 9,,Republican Party,No,7,0,4,11
DeWitt,402,Ballots Cast,,Republican Party,,182,31,147,360
DeWitt,402,Proposition 9,,Republican Party,Undervotes,6,0,3,9
DeWitt,402,Proposition 9,,Republican Party,Overvotes,0,0,0,0
DeWitt,402,Proposition 10,,Republican Party,Yes,162,24,135,321
DeWitt,402,Proposition 10,,Republican Party,No,18,5,8,31
DeWitt,402,Ballots Cast,,Republican Party,,180,29,143,352
DeWitt,402,Proposition 10,,Republican Party,Undervotes,8,2,7,17
DeWitt,402,Proposition 10,,Republican Party,Overvotes,0,0,0,0