county,precinct,office,district,party,candidate,election_day_person,early_voting_person,early_voting_mail,election_day_mail,provisional,votes,early_voting,election_day
Atascosa,1,Ballots Cast,,,,109,129,8,0,0,246,137,109
Atascosa,2,Ballots Cast,,,,119,51,17,0,0,187,68,119
Atascosa,3,Ballots Cast,,,,196,205,22,1,0,424,227,197
Atascosa,4,Ballots Cast,,,,42,11,3,0,0,56,14,42
Atascosa,5,Ballots Cast,,,,168,130,25,3,0,326,155,171
Atascosa,6,Ballots Cast,,,,10,20,3,0,0,33,23,10
Atascosa,7,Ballots Cast,,,,227,104,15,1,1,348,119,228
Atascosa,8,Ballots Cast,,,,80,66,1,0,0,147,67,80
Atascosa,9,Ballots Cast,,,,25,12,2,0,0,39,14,25
Atascosa,10,Ballots Cast,,,,218,95,7,0,0,320,102,218
Atascosa,11,Ballots Cast,,,,21,3,3,0,0,27,6,21
Atascosa,12,Ballots Cast,,,,165,86,17,1,0,269,103,166
Atascosa,13,Ballots Cast,,,,269,427,44,1,0,741,471,270
Atascosa,14,Ballots Cast,,,,53,83,9,1,0,146,92,54
Atascosa,15,Ballots Cast,,,,253,186,41,0,1,481,227,253
Atascosa,16,Ballots Cast,,,,29,39,6,0,0,74,45,29
Atascosa,17,Ballots Cast,,,,298,224,31,2,0,555,255,300
Atascosa,18,Ballots Cast,,,,355,185,30,0,0,570,215,355
Atascosa,19,Ballots Cast,,,,70,83,7,0,0,160,90,70
Atascosa,20,Ballots Cast,,,,558,715,41,1,0,1315,756,559
Atascosa,21,Ballots Cast,,,,51,32,2,0,0,85,34,51
Atascosa,22,Ballots Cast,,,,151,124,7,0,0,282,131,151
Atascosa,23,Ballots Cast,,,,78,47,9,0,0,134,56,78
Atascosa,24,Ballots Cast,,,,205,183,15,1,0,404,198,206
Atascosa,1,Ballots Cast,,REP,,80,107,2,0,0,189,109,80
Atascosa,2,Ballots Cast,,REP,,69,36,3,0,0,108,39,69
Atascosa,3,Ballots Cast,,REP,,115,154,1,0,0,270,155,115
Atascosa,4,Ballots Cast,,REP,,28,10,1,0,0,39,11,28
Atascosa,5,Ballots Cast,,REP,,83,81,6,1,0,171,87,84
Atascosa,6,Ballots Cast,,REP,,8,18,1,0,0,27,19,8
Atascosa,7,Ballots Cast,,REP,,142,77,2,0,1,222,79,142
Atascosa,8,Ballots Cast,,REP,,44,40,0,0,0,84,40,44
Atascosa,9,Ballots Cast,,REP,,19,12,0,0,0,31,12,19
Atascosa,10,Ballots Cast,,REP,,131,57,1,0,0,189,58,131
Atascosa,11,Ballots Cast,,REP,,18,3,0,0,0,21,3,18
Atascosa,12,Ballots Cast,,REP,,106,57,1,0,0,164,58,106
Atascosa,13,Ballots Cast,,REP,,164,315,7,0,0,486,322,164
Atascosa,14,Ballots Cast,,REP,,17,61,2,1,0,81,63,18
Atascosa,15,Ballots Cast,,REP,,123,139,0,0,0,262,139,123
Atascosa,16,Ballots Cast,,REP,,15,27,3,0,0,45,30,15
Atascosa,17,Ballots Cast,,REP,,68,84,3,0,0,155,87,68
Atascosa,18,Ballots Cast,,REP,,138,120,4,0,0,262,124,138
Atascosa,19,Ballots Cast,,REP,,53,53,1,0,0,107,54,53
Atascosa,20,Ballots Cast,,REP,,408,589,16,0,0,1013,605,408
Atascosa,21,Ballots Cast,,REP,,39,27,2,0,0,68,29,39
Atascosa,22,Ballots Cast,,REP,,123,107,2,0,0,232,109,123
Atascosa,23,Ballots Cast,,REP,,34,29,0,0,0,63,29,34
Atascosa,24,Ballots Cast,,REP,,105,126,2,0,0,233,128,105
Atascosa,1,Ballots Cast,,DEM,,29,22,6,0,0,57,28,29
Atascosa,2,Ballots Cast,,DEM,,50,15,14,0,0,79,29,50
Atascosa,3,Ballots Cast,,DEM,,81,51,21,1,0,154,72,82
Atascosa,4,Ballots Cast,,DEM,,14,1,2,0,0,17,3,14
Atascosa,5,Ballots Cast,,DEM,,85,49,19,2,0,155,68,87
Atascosa,6,Ballots Cast,,DEM,,2,2,2,0,0,6,4,2
Atascosa,7,Ballots Cast,,DEM,,85,27,13,1,0,126,40,86
Atascosa,8,Ballots Cast,,DEM,,36,26,1,0,0,63,27,36
Atascosa,9,Ballots Cast,,DEM,,6,0,2,0,0,8,2,6
Atascosa,10,Ballots Cast,,DEM,,87,38,6,0,0,131,44,87
Atascosa,11,Ballots Cast,,DEM,,3,0,3,0,0,6,3,3
Atascosa,12,Ballots Cast,,DEM,,59,29,16,1,0,105,45,60
Atascosa,13,Ballots Cast,,DEM,,105,112,37,1,0,255,149,106
Atascosa,14,Ballots Cast,,DEM,,36,22,7,0,0,65,29,36
Atascosa,15,Ballots Cast,,DEM,,130,47,41,0,1,219,88,130
Atascosa,16,Ballots Cast,,DEM,,14,12,3,0,0,29,15,14
Atascosa,17,Ballots Cast,,DEM,,230,140,28,2,0,400,168,232
Atascosa,18,Ballots Cast,,DEM,,217,65,26,0,0,308,91,217
Atascosa,19,Ballots Cast,,DEM,,17,30,6,0,0,53,36,17
Atascosa,20,Ballots Cast,,DEM,,150,126,25,1,0,302,151,151
Atascosa,21,Ballots Cast,,DEM,,12,5,0,0,0,17,5,12
Atascosa,22,Ballots Cast,,DEM,,28,17,5,0,0,50,22,28
Atascosa,23,Ballots Cast,,DEM,,44,18,9,0,0,71,27,44
Atascosa,24,Ballots Cast,,DEM,,100,57,13,1,0,171,70,101
Atascosa,1,Blank Ballots Cast,,,,0,0,0,0,0,0,0,0
Atascosa,2,Blank Ballots Cast,,,,0,0,0,0,0,0,0,0
Atascosa,3,Blank Ballots Cast,,,,0,0,0,0,0,0,0,0
Atascosa,4,Blank Ballots Cast,,,,0,0,0,0,0,0,0,0
Atascosa,5,Blank Ballots Cast,,,,0,0,0,0,0,0,0,0
Atascosa,6,Blank Ballots Cast,,,,0,0,0,0,0,0,0,0
Atascosa,7,Blank Ballots Cast,,,,0,0,0,0,0,0,0,0
Atascosa,8,Blank Ballots Cast,,,,1,0,0,0,0,1,0,1
Atascosa,9,Blank Ballots Cast,,,,0,0,0,0,0,0,0,0
Atascosa,10,Blank Ballots Cast,,,,0,0,0,0,0,0,0,0
Atascosa,11,Blank Ballots Cast,,,,0,0,0,0,0,0,0,0
Atascosa,12,Blank Ballots Cast,,,,0,0,0,0,0,0,0,0
Atascosa,13,Blank Ballots Cast,,,,0,0,0,0,0,0,0,0
Atascosa,14,Blank Ballots Cast,,,,0,0,0,0,0,0,0,0
Atascosa,15,Blank Ballots Cast,,,,0,0,0,0,0,0,0,0
Atascosa,16,Blank Ballots Cast,,,,0,0,0,0,0,0,0,0
Atascosa,17,Blank Ballots Cast,,,,0,0,0,0,0,0,0,0
Atascosa,18,Blank Ballots Cast,,,,0,0,0,0,0,0,0,0
Atascosa,19,Blank Ballots Cast,,,,0,0,0,0,0,0,0,0
Atascosa,20,Blank Ballots Cast,,,,0,0,0,0,0,0,0,0
Atascosa,21,Blank Ballots Cast,,,,0,0,0,0,0,0,0,0
Atascosa,22,Blank Ballots Cast,,,,0,0,0,0,0,0,0,0
Atascosa,23,Blank Ballots Cast,,,,0,0,0,0,0,0,0,0
Atascosa,24,Blank Ballots Cast,,,,0,0,0,0,0,0,0,0
Atascosa,1,President,,REP,Zoltan G. Istvan,0,0,0,0,0,0,0,0
Atascosa,2,President,,REP,Zoltan G. Istvan,0,0,0,0,0,0,0,0
Atascosa,3,President,,REP,Zoltan G. Istvan,0,0,0,0,0,0,0,0
Atascosa,4,President,,REP,Zoltan G. Istvan,0,0,0,0,0,0,0,0
Atascosa,5,President,,REP,Zoltan G. Istvan,1,0,0,0,0,1,0,1
Atascosa,6,President,,REP,Zoltan G. Istvan,0,0,0,0,0,0,0,0
Atascosa,7,President,,REP,Zoltan G. Istvan,0,0,0,0,0,0,0,0
Atascosa,8,President,,REP,Zoltan G. Istvan,0,0,0,0,0,0,0,0
Atascosa,9,President,,REP,Zoltan G. Istvan,0,0,0,0,0,0,0,0
Atascosa,10,President,,REP,Zoltan G. Istvan,0,0,0,0,0,0,0,0
Atascosa,11,President,,REP,Zoltan G. Istvan,0,0,0,0,0,0,0,0
Atascosa,12,President,,REP,Zoltan G. Istvan,0,0,0,0,0,0,0,0
Atascosa,13,President,,REP,Zoltan G. Istvan,0,0,0,0,0,0,0,0
Atascosa,14,President,,REP,Zoltan G. Istvan,0,0,0,0,0,0,0,0
Atascosa,15,President,,REP,Zoltan G. Istvan,0,0,0,0,0,0,0,0
Atascosa,16,President,,REP,Zoltan G. Istvan,0,0,0,0,0,0,0,0
Atascosa,17,President,,REP,Zoltan G. Istvan,0,0,0,0,0,0,0,0
Atascosa,18,President,,REP,Zoltan G. Istvan,0,0,0,0,0,0,0,0
Atascosa,19,President,,REP,Zoltan G. Istvan,0,0,0,0,0,0,0,0
Atascosa,20,President,,REP,Zoltan G. Istvan,0,1,0,0,0,1,1,0
Atascosa,21,President,,REP,Zoltan G. Istvan,0,0,0,0,0,0,0,0
Atascosa,22,President,,REP,Zoltan G. Istvan,0,0,0,0,0,0,0,0
Atascosa,23,President,,REP,Zoltan G. Istvan,0,0,0,0,0,0,0,0
Atascosa,24,President,,REP,Zoltan G. Istvan,0,0,0,0,0,0,0,0
Atascosa,1,President,,REP,Donald J. Trump,77,102,2,0,0,181,104,77
Atascosa,2,President,,REP,Donald J. Trump,68,34,3,0,0,105,37,68
Atascosa,3,President,,REP,Donald J. Trump,99,143,1,0,0,243,144,99
Atascosa,4,President,,REP,Donald J. Trump,27,9,0,0,0,36,9,27
Atascosa,5,President,,REP,Donald J. Trump,73,77,4,1,0,155,81,74
Atascosa,6,President,,REP,Donald J. Trump,7,18,1,0,0,26,19,7
Atascosa,7,President,,REP,Donald J. Trump,134,75,2,0,1,212,77,134
Atascosa,8,President,,REP,Donald J. Trump,41,40,0,0,0,81,40,41
Atascosa,9,President,,REP,Donald J. Trump,19,11,0,0,0,30,11,19
Atascosa,10,President,,REP,Donald J. Trump,123,54,1,0,0,178,55,123
Atascosa,11,President,,REP,Donald J. Trump,17,3,0,0,0,20,3,17
Atascosa,12,President,,REP,Donald J. Trump,97,55,1,0,0,153,56,97
Atascosa,13,President,,REP,Donald J. Trump,153,299,7,0,0,459,306,153
Atascosa,14,President,,REP,Donald J. Trump,16,58,2,0,0,76,60,16
Atascosa,15,President,,REP,Donald J. Trump,108,124,0,0,0,232,124,108
Atascosa,16,President,,REP,Donald J. Trump,12,27,3,0,0,42,30,12
Atascosa,17,President,,REP,Donald J. Trump,60,74,3,0,0,137,77,60
Atascosa,18,President,,REP,Donald J. Trump,131,114,4,0,0,249,118,131
Atascosa,19,President,,REP,Donald J. Trump,50,46,1,0,0,97,47,50
Atascosa,20,President,,REP,Donald J. Trump,375,559,16,0,0,950,575,375
Atascosa,21,President,,REP,Donald J. Trump,38,27,2,0,0,67,29,38
Atascosa,22,President,,REP,Donald J. Trump,112,97,2,0,0,211,99,112
Atascosa,23,President,,REP,Donald J. Trump,34,27,0,0,0,61,27,34
Atascosa,24,President,,REP,Donald J. Trump,96,121,2,0,0,219,123,96
Atascosa,1,President,,REP,Roque Rocky DeLa Fuente Guerra,0,0,0,0,0,0,0,0
Atascosa,2,President,,REP,Roque Rocky DeLa Fuente Guerra,0,0,0,0,0,0,0,0
Atascosa,3,President,,REP,Roque Rocky DeLa Fuente Guerra,2,1,0,0,0,3,1,2
Atascosa,4,President,,REP,Roque Rocky DeLa Fuente Guerra,0,0,0,0,0,0,0,0
Atascosa,5,President,,REP,Roque Rocky DeLa Fuente Guerra,3,0,2,0,0,5,2,3
Atascosa,6,President,,REP,Roque Rocky DeLa Fuente Guerra,0,0,0,0,0,0,0,0
Atascosa,7,President,,REP,Roque Rocky DeLa Fuente Guerra,0,0,0,0,0,0,0,0
Atascosa,8,President,,REP,Roque Rocky DeLa Fuente Guerra,0,0,0,0,0,0,0,0
Atascosa,9,President,,REP,Roque Rocky DeLa Fuente Guerra,0,0,0,0,0,0,0,0
Atascosa,10,President,,REP,Roque Rocky DeLa Fuente Guerra,2,0,0,0,0,2,0,2
Atascosa,11,President,,REP,Roque Rocky DeLa Fuente Guerra,0,0,0,0,0,0,0,0
Atascosa,12,President,,REP,Roque Rocky DeLa Fuente Guerra,1,0,0,0,0,1,0,1
Atascosa,13,President,,REP,Roque Rocky DeLa Fuente Guerra,1,0,0,0,0,1,0,1
Atascosa,14,President,,REP,Roque Rocky DeLa Fuente Guerra,0,0,0,0,0,0,0,0
Atascosa,15,President,,REP,Roque Rocky DeLa Fuente Guerra,2,1,0,0,0,3,1,2
Atascosa,16,President,,REP,Roque Rocky DeLa Fuente Guerra,0,0,0,0,0,0,0,0
Atascosa,17,President,,REP,Roque Rocky DeLa Fuente Guerra,1,1,0,0,0,2,1,1
Atascosa,18,President,,REP,Roque Rocky DeLa Fuente Guerra,1,1,0,0,0,2,1,1
Atascosa,19,President,,REP,Roque Rocky DeLa Fuente Guerra,0,0,0,0,0,0,0,0
Atascosa,20,President,,REP,Roque Rocky DeLa Fuente Guerra,2,1,0,0,0,3,1,2
Atascosa,21,President,,REP,Roque Rocky DeLa Fuente Guerra,0,0,0,0,0,0,0,0
Atascosa,22,President,,REP,Roque Rocky DeLa Fuente Guerra,3,3,0,0,0,6,3,3
Atascosa,23,President,,REP,Roque Rocky DeLa Fuente Guerra,0,2,0,0,0,2,2,0
Atascosa,24,President,,REP,Roque Rocky DeLa Fuente Guerra,0,0,0,0,0,0,0,0
Atascosa,1,President,,REP,Matthew John Matern,0,0,0,0,0,0,0,0
Atascosa,2,President,,REP,Matthew John Matern,0,0,0,0,0,0,0,0
Atascosa,3,President,,REP,Matthew John Matern,0,0,0,0,0,0,0,0
Atascosa,4,President,,REP,Matthew John Matern,0,0,0,0,0,0,0,0
Atascosa,5,President,,REP,Matthew John Matern,1,0,0,0,0,1,0,1
Atascosa,6,President,,REP,Matthew John Matern,0,0,0,0,0,0,0,0
Atascosa,7,President,,REP,Matthew John Matern,0,0,0,0,0,0,0,0
Atascosa,8,President,,REP,Matthew John Matern,0,0,0,0,0,0,0,0
Atascosa,9,President,,REP,Matthew John Matern,0,0,0,0,0,0,0,0
Atascosa,10,President,,REP,Matthew John Matern,0,0,0,0,0,0,0,0
Atascosa,11,President,,REP,Matthew John Matern,0,0,0,0,0,0,0,0
Atascosa,12,President,,REP,Matthew John Matern,0,0,0,0,0,0,0,0
Atascosa,13,President,,REP,Matthew John Matern,1,1,0,0,0,2,1,1
Atascosa,14,President,,REP,Matthew John Matern,0,0,0,0,0,0,0,0
Atascosa,15,President,,REP,Matthew John Matern,0,1,0,0,0,1,1,0
Atascosa,16,President,,REP,Matthew John Matern,0,0,0,0,0,0,0,0
Atascosa,17,President,,REP,Matthew John Matern,0,1,0,0,0,1,1,0
Atascosa,18,President,,REP,Matthew John Matern,0,1,0,0,0,1,1,0
Atascosa,19,President,,REP,Matthew John Matern,0,0,0,0,0,0,0,0
Atascosa,20,President,,REP,Matthew John Matern,0,1,0,0,0,1,1,0
Atascosa,21,President,,REP,Matthew John Matern,1,0,0,0,0,1,0,1
Atascosa,22,President,,REP,Matthew John Matern,0,0,0,0,0,0,0,0
Atascosa,23,President,,REP,Matthew John Matern,0,0,0,0,0,0,0,0
Atascosa,24,President,,REP,Matthew John Matern,0,1,0,0,0,1,1,0
Atascosa,1,President,,REP,Joe Walsh,0,0,0,0,0,0,0,0
Atascosa,2,President,,REP,Joe Walsh,0,1,0,0,0,1,1,0
Atascosa,3,President,,REP,Joe Walsh,2,2,0,0,0,4,2,2
Atascosa,4,President,,REP,Joe Walsh,1,0,1,0,0,2,1,1
Atascosa,5,President,,REP,Joe Walsh,1,1,0,0,0,2,1,1
Atascosa,6,President,,REP,Joe Walsh,0,0,0,0,0,0,0,0
Atascosa,7,President,,REP,Joe Walsh,1,0,0,0,0,1,0,1
Atascosa,8,President,,REP,Joe Walsh,1,0,0,0,0,1,0,1
Atascosa,9,President,,REP,Joe Walsh,0,0,0,0,0,0,0,0
Atascosa,10,President,,REP,Joe Walsh,1,0,0,0,0,1,0,1
Atascosa,11,President,,REP,Joe Walsh,0,0,0,0,0,0,0,0
Atascosa,12,President,,REP,Joe Walsh,0,0,0,0,0,0,0,0
Atascosa,13,President,,REP,Joe Walsh,0,3,0,0,0,3,3,0
Atascosa,14,President,,REP,Joe Walsh,0,1,0,0,0,1,1,0
Atascosa,15,President,,REP,Joe Walsh,1,0,0,0,0,1,0,1
Atascosa,16,President,,REP,Joe Walsh,0,0,0,0,0,0,0,0
Atascosa,17,President,,REP,Joe Walsh,2,1,0,0,0,3,1,2
Atascosa,18,President,,REP,Joe Walsh,1,0,0,0,0,1,0,1
Atascosa,19,President,,REP,Joe Walsh,0,0,0,0,0,0,0,0
Atascosa,20,President,,REP,Joe Walsh,1,2,0,0,0,3,2,1
Atascosa,21,President,,REP,Joe Walsh,0,0,0,0,0,0,0,0
Atascosa,22,President,,REP,Joe Walsh,0,0,0,0,0,0,0,0
Atascosa,23,President,,REP,Joe Walsh,0,0,0,0,0,0,0,0
Atascosa,24,President,,REP,Joe Walsh,1,2,0,0,0,3,2,1
Atascosa,1,President,,REP,Bill Weld,1,0,0,0,0,1,0,1
Atascosa,2,President,,REP,Bill Weld,0,0,0,0,0,0,0,0
Atascosa,3,President,,REP,Bill Weld,0,0,0,0,0,0,0,0
Atascosa,4,President,,REP,Bill Weld,0,0,0,0,0,0,0,0
Atascosa,5,President,,REP,Bill Weld,0,0,0,0,0,0,0,0
Atascosa,6,President,,REP,Bill Weld,0,0,0,0,0,0,0,0
Atascosa,7,President,,REP,Bill Weld,0,1,0,0,0,1,1,0
Atascosa,8,President,,REP,Bill Weld,0,0,0,0,0,0,0,0
Atascosa,9,President,,REP,Bill Weld,0,0,0,0,0,0,0,0
Atascosa,10,President,,REP,Bill Weld,0,0,0,0,0,0,0,0
Atascosa,11,President,,REP,Bill Weld,0,0,0,0,0,0,0,0
Atascosa,12,President,,REP,Bill Weld,1,0,0,0,0,1,0,1
Atascosa,13,President,,REP,Bill Weld,0,1,0,0,0,1,1,0
Atascosa,14,President,,REP,Bill Weld,0,0,0,0,0,0,0,0
Atascosa,15,President,,REP,Bill Weld,1,1,0,0,0,2,1,1
Atascosa,16,President,,REP,Bill Weld,0,0,0,0,0,0,0,0
Atascosa,17,President,,REP,Bill Weld,0,0,0,0,0,0,0,0
Atascosa,18,President,,REP,Bill Weld,0,0,0,0,0,0,0,0
Atascosa,19,President,,REP,Bill Weld,0,0,0,0,0,0,0,0
Atascosa,20,President,,REP,Bill Weld,0,5,0,0,0,5,5,0
Atascosa,21,President,,REP,Bill Weld,0,0,0,0,0,0,0,0
Atascosa,22,President,,REP,Bill Weld,0,0,0,0,0,0,0,0
Atascosa,23,President,,REP,Bill Weld,0,0,0,0,0,0,0,0
Atascosa,24,President,,REP,Bill Weld,3,0,0,0,0,3,0,3
Atascosa,1,President,,REP,Bob Ely,0,0,0,0,0,0,0,0
Atascosa,2,President,,REP,Bob Ely,0,0,0,0,0,0,0,0
Atascosa,3,President,,REP,Bob Ely,0,0,0,0,0,0,0,0
Atascosa,4,President,,REP,Bob Ely,0,0,0,0,0,0,0,0
Atascosa,5,President,,REP,Bob Ely,0,0,0,0,0,0,0,0
Atascosa,6,President,,REP,Bob Ely,0,0,0,0,0,0,0,0
Atascosa,7,President,,REP,Bob Ely,0,0,0,0,0,0,0,0
Atascosa,8,President,,REP,Bob Ely,0,0,0,0,0,0,0,0
Atascosa,9,President,,REP,Bob Ely,0,0,0,0,0,0,0,0
Atascosa,10,President,,REP,Bob Ely,0,0,0,0,0,0,0,0
Atascosa,11,President,,REP,Bob Ely,0,0,0,0,0,0,0,0
Atascosa,12,President,,REP,Bob Ely,1,0,0,0,0,1,0,1
Atascosa,13,President,,REP,Bob Ely,2,0,0,0,0,2,0,2
Atascosa,14,President,,REP,Bob Ely,0,0,0,0,0,0,0,0
Atascosa,15,President,,REP,Bob Ely,1,0,0,0,0,1,0,1
Atascosa,16,President,,REP,Bob Ely,0,0,0,0,0,0,0,0
Atascosa,17,President,,REP,Bob Ely,0,0,0,0,0,0,0,0
Atascosa,18,President,,REP,Bob Ely,0,0,0,0,0,0,0,0
Atascosa,19,President,,REP,Bob Ely,0,0,0,0,0,0,0,0
Atascosa,20,President,,REP,Bob Ely,1,0,0,0,0,1,0,1
Atascosa,21,President,,REP,Bob Ely,0,0,0,0,0,0,0,0
Atascosa,22,President,,REP,Bob Ely,0,0,0,0,0,0,0,0
Atascosa,23,President,,REP,Bob Ely,0,0,0,0,0,0,0,0
Atascosa,24,President,,REP,Bob Ely,0,0,0,0,0,0,0,0
Atascosa,1,President,,REP,Uncommitted,1,5,0,0,0,6,5,1
Atascosa,2,President,,REP,Uncommitted,1,1,0,0,0,2,1,1
Atascosa,3,President,,REP,Uncommitted,11,8,0,0,0,19,8,11
Atascosa,4,President,,REP,Uncommitted,0,1,0,0,0,1,1,0
Atascosa,5,President,,REP,Uncommitted,4,2,0,0,0,6,2,4
Atascosa,6,President,,REP,Uncommitted,1,0,0,0,0,1,0,1
Atascosa,7,President,,REP,Uncommitted,3,1,0,0,0,4,1,3
Atascosa,8,President,,REP,Uncommitted,1,0,0,0,0,1,0,1
Atascosa,9,President,,REP,Uncommitted,0,1,0,0,0,1,1,0
Atascosa,10,President,,REP,Uncommitted,5,3,0,0,0,8,3,5
Atascosa,11,President,,REP,Uncommitted,1,0,0,0,0,1,0,1
Atascosa,12,President,,REP,Uncommitted,4,2,0,0,0,6,2,4
Atascosa,13,President,,REP,Uncommitted,7,10,0,0,0,17,10,7
Atascosa,14,President,,REP,Uncommitted,1,1,0,1,0,3,1,2
Atascosa,15,President,,REP,Uncommitted,9,9,0,0,0,18,9,9
Atascosa,16,President,,REP,Uncommitted,1,0,0,0,0,1,0,1
Atascosa,17,President,,REP,Uncommitted,4,5,0,0,0,9,5,4
Atascosa,18,President,,REP,Uncommitted,3,2,0,0,0,5,2,3
Atascosa,19,President,,REP,Uncommitted,3,7,0,0,0,10,7,3
Atascosa,20,President,,REP,Uncommitted,27,18,0,0,0,45,18,27
Atascosa,21,President,,REP,Uncommitted,0,0,0,0,0,0,0,0
Atascosa,22,President,,REP,Uncommitted,3,6,0,0,0,9,6,3
Atascosa,23,President,,REP,Uncommitted,0,0,0,0,0,0,0,0
Atascosa,24,President,,REP,Uncommitted,5,2,0,0,0,7,2,5
Atascosa,1,President,,REP,Over Votes,0,0,0,0,0,0,0,0
Atascosa,2,President,,REP,Over Votes,0,0,0,0,0,0,0,0
Atascosa,3,President,,REP,Over Votes,0,0,0,0,0,0,0,0
Atascosa,4,President,,REP,Over Votes,0,0,0,0,0,0,0,0
Atascosa,5,President,,REP,Over Votes,0,0,0,0,0,0,0,0
Atascosa,6,President,,REP,Over Votes,0,0,0,0,0,0,0,0
Atascosa,7,President,,REP,Over Votes,0,0,0,0,0,0,0,0
Atascosa,8,President,,REP,Over Votes,0,0,0,0,0,0,0,0
Atascosa,9,President,,REP,Over Votes,0,0,0,0,0,0,0,0
Atascosa,10,President,,REP,Over Votes,0,0,0,0,0,0,0,0
Atascosa,11,President,,REP,Over Votes,0,0,0,0,0,0,0,0
Atascosa,12,President,,REP,Over Votes,0,0,0,0,0,0,0,0
Atascosa,13,President,,REP,Over Votes,0,0,0,0,0,0,0,0
Atascosa,14,President,,REP,Over Votes,0,0,0,0,0,0,0,0
Atascosa,15,President,,REP,Over Votes,0,0,0,0,0,0,0,0
Atascosa,16,President,,REP,Over Votes,0,0,0,0,0,0,0,0
Atascosa,17,President,,REP,Over Votes,0,0,0,0,0,0,0,0
Atascosa,18,President,,REP,Over Votes,0,0,0,0,0,0,0,0
Atascosa,19,President,,REP,Over Votes,0,0,0,0,0,0,0,0
Atascosa,20,President,,REP,Over Votes,0,0,0,0,0,0,0,0
Atascosa,21,President,,REP,Over Votes,0,0,0,0,0,0,0,0
Atascosa,22,President,,REP,Over Votes,0,0,0,0,0,0,0,0
Atascosa,23,President,,REP,Over Votes,0,0,0,0,0,0,0,0
Atascosa,24,President,,REP,Over Votes,0,0,0,0,0,0,0,0
Atascosa,1,President,,REP,Under Votes,1,0,0,0,0,1,0,1
Atascosa,2,President,,REP,Under Votes,0,0,0,0,0,0,0,0
Atascosa,3,President,,REP,Under Votes,1,0,0,0,0,1,0,1
Atascosa,4,President,,REP,Under Votes,0,0,0,0,0,0,0,0
Atascosa,5,President,,REP,Under Votes,0,1,0,0,0,1,1,0
Atascosa,6,President,,REP,Under Votes,0,0,0,0,0,0,0,0
Atascosa,7,President,,REP,Under Votes,4,0,0,0,0,4,0,4
Atascosa,8,President,,REP,Under Votes,1,0,0,0,0,1,0,1
Atascosa,9,President,,REP,Under Votes,0,0,0,0,0,0,0,0
Atascosa,10,President,,REP,Under Votes,0,0,0,0,0,0,0,0
Atascosa,11,President,,REP,Under Votes,0,0,0,0,0,0,0,0
Atascosa,12,President,,REP,Under Votes,2,0,0,0,0,2,0,2
Atascosa,13,President,,REP,Under Votes,0,1,0,0,0,1,1,0
Atascosa,14,President,,REP,Under Votes,0,1,0,0,0,1,1,0
Atascosa,15,President,,REP,Under Votes,1,3,0,0,0,4,3,1
Atascosa,16,President,,REP,Under Votes,2,0,0,0,0,2,0,2
Atascosa,17,President,,REP,Under Votes,1,2,0,0,0,3,2,1
Atascosa,18,President,,REP,Under Votes,2,2,0,0,0,4,2,2
Atascosa,19,President,,REP,Under Votes,0,0,0,0,0,0,0,0
Atascosa,20,President,,REP,Under Votes,2,2,0,0,0,4,2,2
Atascosa,21,President,,REP,Under Votes,0,0,0,0,0,0,0,0
Atascosa,22,President,,REP,Under Votes,5,1,0,0,0,6,1,5
Atascosa,23,President,,REP,Under Votes,0,0,0,0,0,0,0,0
Atascosa,24,President,,REP,Under Votes,0,0,0,0,0,0,0,0
Atascosa,1,U.S. Senate,,REP,Mark Yancey,9,10,0,0,0,19,10,9
Atascosa,2,U.S. Senate,,REP,Mark Yancey,7,2,0,0,0,9,2,7
Atascosa,3,U.S. Senate,,REP,Mark Yancey,15,11,0,0,0,26,11,15
Atascosa,4,U.S. Senate,,REP,Mark Yancey,2,1,0,0,0,3,1,2
Atascosa,5,U.S. Senate,,REP,Mark Yancey,16,7,0,0,0,23,7,16
Atascosa,6,U.S. Senate,,REP,Mark Yancey,3,2,0,0,0,5,2,3
Atascosa,7,U.S. Senate,,REP,Mark Yancey,27,8,0,0,0,35,8,27
Atascosa,8,U.S. Senate,,REP,Mark Yancey,5,4,0,0,0,9,4,5
Atascosa,9,U.S. Senate,,REP,Mark Yancey,2,1,0,0,0,3,1,2
Atascosa,10,U.S. Senate,,REP,Mark Yancey,18,5,0,0,0,23,5,18
Atascosa,11,U.S. Senate,,REP,Mark Yancey,0,0,0,0,0,0,0,0
Atascosa,12,U.S. Senate,,REP,Mark Yancey,5,3,1,0,0,9,4,5
Atascosa,13,U.S. Senate,,REP,Mark Yancey,28,34,0,0,0,62,34,28
Atascosa,14,U.S. Senate,,REP,Mark Yancey,1,3,0,1,0,5,3,2
Atascosa,15,U.S. Senate,,REP,Mark Yancey,15,10,0,0,0,25,10,15
Atascosa,16,U.S. Senate,,REP,Mark Yancey,4,2,0,0,0,6,2,4
Atascosa,17,U.S. Senate,,REP,Mark Yancey,5,8,0,0,0,13,8,5
Atascosa,18,U.S. Senate,,REP,Mark Yancey,19,12,0,0,0,31,12,19
Atascosa,19,U.S. Senate,,REP,Mark Yancey,13,4,0,0,0,17,4,13
Atascosa,20,U.S. Senate,,REP,Mark Yancey,53,48,1,0,0,102,49,53
Atascosa,21,U.S. Senate,,REP,Mark Yancey,6,2,0,0,0,8,2,6
Atascosa,22,U.S. Senate,,REP,Mark Yancey,9,11,0,0,0,20,11,9
Atascosa,23,U.S. Senate,,REP,Mark Yancey,9,1,0,0,0,10,1,9
Atascosa,24,U.S. Senate,,REP,Mark Yancey,11,10,0,0,0,21,10,11
Atascosa,1,U.S. Senate,,REP,Dwayne Stovall,5,4,0,0,0,9,4,5
Atascosa,2,U.S. Senate,,REP,Dwayne Stovall,8,2,0,0,0,10,2,8
Atascosa,3,U.S. Senate,,REP,Dwayne Stovall,13,14,0,0,0,27,14,13
Atascosa,4,U.S. Senate,,REP,Dwayne Stovall,2,1,0,0,0,3,1,2
Atascosa,5,U.S. Senate,,REP,Dwayne Stovall,9,10,0,0,0,19,10,9
Atascosa,6,U.S. Senate,,REP,Dwayne Stovall,2,2,0,0,0,4,2,2
Atascosa,7,U.S. Senate,,REP,Dwayne Stovall,14,2,0,0,0,16,2,14
Atascosa,8,U.S. Senate,,REP,Dwayne Stovall,2,7,0,0,0,9,7,2
Atascosa,9,U.S. Senate,,REP,Dwayne Stovall,1,0,0,0,0,1,0,1
Atascosa,10,U.S. Senate,,REP,Dwayne Stovall,10,1,0,0,0,11,1,10
Atascosa,11,U.S. Senate,,REP,Dwayne Stovall,1,0,0,0,0,1,0,1
Atascosa,12,U.S. Senate,,REP,Dwayne Stovall,21,4,0,0,0,25,4,21
Atascosa,13,U.S. Senate,,REP,Dwayne Stovall,22,29,0,0,0,51,29,22
Atascosa,14,U.S. Senate,,REP,Dwayne Stovall,1,8,0,0,0,9,8,1
Atascosa,15,U.S. Senate,,REP,Dwayne Stovall,14,16,0,0,0,30,16,14
Atascosa,16,U.S. Senate,,REP,Dwayne Stovall,4,4,0,0,0,8,4,4
Atascosa,17,U.S. Senate,,REP,Dwayne Stovall,3,11,0,0,0,14,11,3
Atascosa,18,U.S. Senate,,REP,Dwayne Stovall,9,9,0,0,0,18,9,9
Atascosa,19,U.S. Senate,,REP,Dwayne Stovall,4,4,0,0,0,8,4,4
Atascosa,20,U.S. Senate,,REP,Dwayne Stovall,31,42,1,0,0,74,43,31
Atascosa,21,U.S. Senate,,REP,Dwayne Stovall,7,3,0,0,0,10,3,7
Atascosa,22,U.S. Senate,,REP,Dwayne Stovall,11,9,2,0,0,22,11,11
Atascosa,23,U.S. Senate,,REP,Dwayne Stovall,3,2,0,0,0,5,2,3
Atascosa,24,U.S. Senate,,REP,Dwayne Stovall,11,13,0,0,0,24,13,11
Atascosa,1,U.S. Senate,,REP,John Cornyn,56,87,2,0,0,145,89,56
Atascosa,2,U.S. Senate,,REP,John Cornyn,48,26,3,0,0,77,29,48
Atascosa,3,U.S. Senate,,REP,John Cornyn,72,110,1,0,0,183,111,72
Atascosa,4,U.S. Senate,,REP,John Cornyn,21,8,0,0,0,29,8,21
Atascosa,5,U.S. Senate,,REP,John Cornyn,43,55,4,1,0,103,59,44
Atascosa,6,U.S. Senate,,REP,John Cornyn,2,14,1,0,0,17,15,2
Atascosa,7,U.S. Senate,,REP,John Cornyn,78,58,2,0,1,139,60,78
Atascosa,8,U.S. Senate,,REP,John Cornyn,34,25,0,0,0,59,25,34
Atascosa,9,U.S. Senate,,REP,John Cornyn,13,11,0,0,0,24,11,13
Atascosa,10,U.S. Senate,,REP,John Cornyn,90,45,1,0,0,136,46,90
Atascosa,11,U.S. Senate,,REP,John Cornyn,17,3,0,0,0,20,3,17
Atascosa,12,U.S. Senate,,REP,John Cornyn,72,49,0,0,0,121,49,72
Atascosa,13,U.S. Senate,,REP,John Cornyn,88,221,7,0,0,316,228,88
Atascosa,14,U.S. Senate,,REP,John Cornyn,14,45,2,0,0,61,47,14
Atascosa,15,U.S. Senate,,REP,John Cornyn,73,93,0,0,0,166,93,73
Atascosa,16,U.S. Senate,,REP,John Cornyn,5,20,3,0,0,28,23,5
Atascosa,17,U.S. Senate,,REP,John Cornyn,45,56,3,0,0,104,59,45
Atascosa,18,U.S. Senate,,REP,John Cornyn,87,79,4,0,0,170,83,87
Atascosa,19,U.S. Senate,,REP,John Cornyn,29,35,1,0,0,65,36,29
Atascosa,20,U.S. Senate,,REP,John Cornyn,268,446,13,0,0,727,459,268
Atascosa,21,U.S. Senate,,REP,John Cornyn,24,21,2,0,0,47,23,24
Atascosa,22,U.S. Senate,,REP,John Cornyn,84,78,0,0,0,162,78,84
Atascosa,23,U.S. Senate,,REP,John Cornyn,18,22,0,0,0,40,22,18
Atascosa,24,U.S. Senate,,REP,John Cornyn,71,91,2,0,0,164,93,71
Atascosa,1,U.S. Senate,,REP,John Anthony Castro,8,4,0,0,0,12,4,8
Atascosa,2,U.S. Senate,,REP,John Anthony Castro,6,3,0,0,0,9,3,6
Atascosa,3,U.S. Senate,,REP,John Anthony Castro,10,14,0,0,0,24,14,10
Atascosa,4,U.S. Senate,,REP,John Anthony Castro,1,0,1,0,0,2,1,1
Atascosa,5,U.S. Senate,,REP,John Anthony Castro,11,4,2,0,0,17,6,11
Atascosa,6,U.S. Senate,,REP,John Anthony Castro,0,0,0,0,0,0,0,0
Atascosa,7,U.S. Senate,,REP,John Anthony Castro,13,5,0,0,0,18,5,13
Atascosa,8,U.S. Senate,,REP,John Anthony Castro,2,3,0,0,0,5,3,2
Atascosa,9,U.S. Senate,,REP,John Anthony Castro,1,0,0,0,0,1,0,1
Atascosa,10,U.S. Senate,,REP,John Anthony Castro,11,4,0,0,0,15,4,11
Atascosa,11,U.S. Senate,,REP,John Anthony Castro,0,0,0,0,0,0,0,0
Atascosa,12,U.S. Senate,,REP,John Anthony Castro,6,0,0,0,0,6,0,6
Atascosa,13,U.S. Senate,,REP,John Anthony Castro,18,13,0,0,0,31,13,18
Atascosa,14,U.S. Senate,,REP,John Anthony Castro,1,4,0,0,0,5,4,1
Atascosa,15,U.S. Senate,,REP,John Anthony Castro,14,13,0,0,0,27,13,14
Atascosa,16,U.S. Senate,,REP,John Anthony Castro,1,1,0,0,0,2,1,1
Atascosa,17,U.S. Senate,,REP,John Anthony Castro,12,6,0,0,0,18,6,12
Atascosa,18,U.S. Senate,,REP,John Anthony Castro,11,11,0,0,0,22,11,11
Atascosa,19,U.S. Senate,,REP,John Anthony Castro,5,7,0,0,0,12,7,5
Atascosa,20,U.S. Senate,,REP,John Anthony Castro,41,33,0,0,0,74,33,41
Atascosa,21,U.S. Senate,,REP,John Anthony Castro,2,1,0,0,0,3,1,2
Atascosa,22,U.S. Senate,,REP,John Anthony Castro,8,4,0,0,0,12,4,8
Atascosa,23,U.S. Senate,,REP,John Anthony Castro,3,3,0,0,0,6,3,3
Atascosa,24,U.S. Senate,,REP,John Anthony Castro,9,6,0,0,0,15,6,9
Atascosa,1,U.S. Senate,,REP,Virgil Bierschwale,1,1,0,0,0,2,1,1
Atascosa,2,U.S. Senate,,REP,Virgil Bierschwale,0,2,0,0,0,2,2,0
Atascosa,3,U.S. Senate,,REP,Virgil Bierschwale,1,0,0,0,0,1,0,1
Atascosa,4,U.S. Senate,,REP,Virgil Bierschwale,0,0,0,0,0,0,0,0
Atascosa,5,U.S. Senate,,REP,Virgil Bierschwale,2,2,0,0,0,4,2,2
Atascosa,6,U.S. Senate,,REP,Virgil Bierschwale,1,0,0,0,0,1,0,1
Atascosa,7,U.S. Senate,,REP,Virgil Bierschwale,1,0,0,0,0,1,0,1
Atascosa,8,U.S. Senate,,REP,Virgil Bierschwale,1,0,0,0,0,1,0,1
Atascosa,9,U.S. Senate,,REP,Virgil Bierschwale,1,0,0,0,0,1,0,1
Atascosa,10,U.S. Senate,,REP,Virgil Bierschwale,0,1,0,0,0,1,1,0
Atascosa,11,U.S. Senate,,REP,Virgil Bierschwale,0,0,0,0,0,0,0,0
Atascosa,12,U.S. Senate,,REP,Virgil Bierschwale,0,0,0,0,0,0,0,0
Atascosa,13,U.S. Senate,,REP,Virgil Bierschwale,3,3,0,0,0,6,3,3
Atascosa,14,U.S. Senate,,REP,Virgil Bierschwale,0,0,0,0,0,0,0,0
Atascosa,15,U.S. Senate,,REP,Virgil Bierschwale,1,2,0,0,0,3,2,1
Atascosa,16,U.S. Senate,,REP,Virgil Bierschwale,0,0,0,0,0,0,0,0
Atascosa,17,U.S. Senate,,REP,Virgil Bierschwale,1,1,0,0,0,2,1,1
Atascosa,18,U.S. Senate,,REP,Virgil Bierschwale,2,3,0,0,0,5,3,2
Atascosa,19,U.S. Senate,,REP,Virgil Bierschwale,0,1,0,0,0,1,1,0
Atascosa,20,U.S. Senate,,REP,Virgil Bierschwale,4,7,0,0,0,11,7,4
Atascosa,21,U.S. Senate,,REP,Virgil Bierschwale,0,0,0,0,0,0,0,0
Atascosa,22,U.S. Senate,,REP,Virgil Bierschwale,0,1,0,0,0,1,1,0
Atascosa,23,U.S. Senate,,REP,Virgil Bierschwale,0,0,0,0,0,0,0,0
Atascosa,24,U.S. Senate,,REP,Virgil Bierschwale,0,3,0,0,0,3,3,0
Atascosa,1,U.S. Senate,,REP,Over Votes,0,0,0,0,0,0,0,0
Atascosa,2,U.S. Senate,,REP,Over Votes,0,0,0,0,0,0,0,0
Atascosa,3,U.S. Senate,,REP,Over Votes,0,0,0,0,0,0,0,0
Atascosa,4,U.S. Senate,,REP,Over Votes,0,0,0,0,0,0,0,0
Atascosa,5,U.S. Senate,,REP,Over Votes,0,0,0,0,0,0,0,0
Atascosa,6,U.S. Senate,,REP,Over Votes,0,0,0,0,0,0,0,0
Atascosa,7,U.S. Senate,,REP,Over Votes,0,0,0,0,0,0,0,0
Atascosa,8,U.S. Senate,,REP,Over Votes,0,0,0,0,0,0,0,0
Atascosa,9,U.S. Senate,,REP,Over Votes,0,0,0,0,0,0,0,0
Atascosa,10,U.S. Senate,,REP,Over Votes,0,0,0,0,0,0,0,0
Atascosa,11,U.S. Senate,,REP,Over Votes,0,0,0,0,0,0,0,0
Atascosa,12,U.S. Senate,,REP,Over Votes,0,0,0,0,0,0,0,0
Atascosa,13,U.S. Senate,,REP,Over Votes,0,0,0,0,0,0,0,0
Atascosa,14,U.S. Senate,,REP,Over Votes,0,0,0,0,0,0,0,0
Atascosa,15,U.S. Senate,,REP,Over Votes,0,0,0,0,0,0,0,0
Atascosa,16,U.S. Senate,,REP,Over Votes,0,0,0,0,0,0,0,0
Atascosa,17,U.S. Senate,,REP,Over Votes,0,0,0,0,0,0,0,0
Atascosa,18,U.S. Senate,,REP,Over Votes,0,0,0,0,0,0,0,0
Atascosa,19,U.S. Senate,,REP,Over Votes,0,0,0,0,0,0,0,0
Atascosa,20,U.S. Senate,,REP,Over Votes,0,0,0,0,0,0,0,0
Atascosa,21,U.S. Senate,,REP,Over Votes,0,0,0,0,0,0,0,0
Atascosa,22,U.S. Senate,,REP,Over Votes,0,0,0,0,0,0,0,0
Atascosa,23,U.S. Senate,,REP,Over Votes,0,0,0,0,0,0,0,0
Atascosa,24,U.S. Senate,,REP,Over Votes,0,0,0,0,0,0,0,0
Atascosa,1,U.S. Senate,,REP,Under Votes,1,1,0,0,0,2,1,1
Atascosa,2,U.S. Senate,,REP,Under Votes,0,1,0,0,0,1,1,0
Atascosa,3,U.S. Senate,,REP,Under Votes,4,5,0,0,0,9,5,4
Atascosa,4,U.S. Senate,,REP,Under Votes,2,0,0,0,0,2,0,2
Atascosa,5,U.S. Senate,,REP,Under Votes,2,3,0,0,0,5,3,2
Atascosa,6,U.S. Senate,,REP,Under Votes,0,0,0,0,0,0,0,0
Atascosa,7,U.S. Senate,,REP,Under Votes,9,4,0,0,0,13,4,9
Atascosa,8,U.S. Senate,,REP,Under Votes,0,1,0,0,0,1,1,0
Atascosa,9,U.S. Senate,,REP,Under Votes,1,0,0,0,0,1,0,1
Atascosa,10,U.S. Senate,,REP,Under Votes,2,1,0,0,0,3,1,2
Atascosa,11,U.S. Senate,,REP,Under Votes,0,0,0,0,0,0,0,0
Atascosa,12,U.S. Senate,,REP,Under Votes,2,1,0,0,0,3,1,2
Atascosa,13,U.S. Senate,,REP,Under Votes,5,15,0,0,0,20,15,5
Atascosa,14,U.S. Senate,,REP,Under Votes,0,1,0,0,0,1,1,0
Atascosa,15,U.S. Senate,,REP,Under Votes,6,5,0,0,0,11,5,6
Atascosa,16,U.S. Senate,,REP,Under Votes,1,0,0,0,0,1,0,1
Atascosa,17,U.S. Senate,,REP,Under Votes,2,2,0,0,0,4,2,2
Atascosa,18,U.S. Senate,,REP,Under Votes,10,6,0,0,0,16,6,10
Atascosa,19,U.S. Senate,,REP,Under Votes,2,2,0,0,0,4,2,2
Atascosa,20,U.S. Senate,,REP,Under Votes,11,13,1,0,0,25,14,11
Atascosa,21,U.S. Senate,,REP,Under Votes,0,0,0,0,0,0,0,0
Atascosa,22,U.S. Senate,,REP,Under Votes,11,4,0,0,0,15,4,11
Atascosa,23,U.S. Senate,,REP,Under Votes,1,1,0,0,0,2,1,1
Atascosa,24,U.S. Senate,,REP,Under Votes,3,3,0,0,0,6,3,3
Atascosa,1,U.S. House,28,REP,Sandra Whitten,77,100,0,0,0,177,100,77
Atascosa,2,U.S. House,28,REP,Sandra Whitten,68,33,3,0,0,104,36,68
Atascosa,3,U.S. House,28,REP,Sandra Whitten,107,143,1,0,0,251,144,107
Atascosa,4,U.S. House,28,REP,Sandra Whitten,24,7,0,0,0,31,7,24
Atascosa,5,U.S. House,28,REP,Sandra Whitten,78,75,6,1,0,160,81,79
Atascosa,6,U.S. House,28,REP,Sandra Whitten,6,17,1,0,0,24,18,6
Atascosa,7,U.S. House,28,REP,Sandra Whitten,130,75,2,0,1,208,77,130
Atascosa,8,U.S. House,28,REP,Sandra Whitten,42,37,0,0,0,79,37,42
Atascosa,9,U.S. House,28,REP,Sandra Whitten,19,11,0,0,0,30,11,19
Atascosa,10,U.S. House,28,REP,Sandra Whitten,126,55,1,0,0,182,56,126
Atascosa,11,U.S. House,28,REP,Sandra Whitten,15,1,0,0,0,16,1,15
Atascosa,12,U.S. House,28,REP,Sandra Whitten,102,53,1,0,0,156,54,102
Atascosa,13,U.S. House,28,REP,Sandra Whitten,155,294,6,0,0,455,300,155
Atascosa,14,U.S. House,28,REP,Sandra Whitten,17,57,2,1,0,77,59,18
Atascosa,15,U.S. House,28,REP,Sandra Whitten,115,125,0,0,0,240,125,115
Atascosa,16,U.S. House,28,REP,Sandra Whitten,13,26,3,0,0,42,29,13
Atascosa,17,U.S. House,28,REP,Sandra Whitten,62,76,3,0,0,141,79,62
Atascosa,18,U.S. House,28,REP,Sandra Whitten,126,108,4,0,0,238,112,126
Atascosa,19,U.S. House,28,REP,Sandra Whitten,52,49,0,0,0,101,49,52
Atascosa,20,U.S. House,28,REP,Sandra Whitten,386,551,14,0,0,951,565,386
Atascosa,21,U.S. House,28,REP,Sandra Whitten,39,25,2,0,0,66,27,39
Atascosa,22,U.S. House,28,REP,Sandra Whitten,102,98,2,0,0,202,100,102
Atascosa,23,U.S. House,28,REP,Sandra Whitten,31,28,0,0,0,59,28,31
Atascosa,24,U.S. House,28,REP,Sandra Whitten,99,115,2,0,0,216,117,99
Atascosa,1,U.S. House,28,REP,Over Votes,0,0,0,0,0,0,0,0
Atascosa,2,U.S. House,28,REP,Over Votes,0,0,0,0,0,0,0,0
Atascosa,3,U.S. House,28,REP,Over Votes,0,0,0,0,0,0,0,0
Atascosa,4,U.S. House,28,REP,Over Votes,0,0,0,0,0,0,0,0
Atascosa,5,U.S. House,28,REP,Over Votes,0,0,0,0,0,0,0,0
Atascosa,6,U.S. House,28,REP,Over Votes,0,0,0,0,0,0,0,0
Atascosa,7,U.S. House,28,REP,Over Votes,0,0,0,0,0,0,0,0
Atascosa,8,U.S. House,28,REP,Over Votes,0,0,0,0,0,0,0,0
Atascosa,9,U.S. House,28,REP,Over Votes,0,0,0,0,0,0,0,0
Atascosa,10,U.S. House,28,REP,Over Votes,0,0,0,0,0,0,0,0
Atascosa,11,U.S. House,28,REP,Over Votes,0,0,0,0,0,0,0,0
Atascosa,12,U.S. House,28,REP,Over Votes,0,0,0,0,0,0,0,0
Atascosa,13,U.S. House,28,REP,Over Votes,0,0,0,0,0,0,0,0
Atascosa,14,U.S. House,28,REP,Over Votes,0,0,0,0,0,0,0,0
Atascosa,15,U.S. House,28,REP,Over Votes,0,0,0,0,0,0,0,0
Atascosa,16,U.S. House,28,REP,Over Votes,0,0,0,0,0,0,0,0
Atascosa,17,U.S. House,28,REP,Over Votes,0,0,0,0,0,0,0,0
Atascosa,18,U.S. House,28,REP,Over Votes,0,0,0,0,0,0,0,0
Atascosa,19,U.S. House,28,REP,Over Votes,0,0,0,0,0,0,0,0
Atascosa,20,U.S. House,28,REP,Over Votes,0,0,0,0,0,0,0,0
Atascosa,21,U.S. House,28,REP,Over Votes,0,0,0,0,0,0,0,0
Atascosa,22,U.S. House,28,REP,Over Votes,0,0,0,0,0,0,0,0
Atascosa,23,U.S. House,28,REP,Over Votes,0,0,0,0,0,0,0,0
Atascosa,24,U.S. House,28,REP,Over Votes,0,0,0,0,0,0,0,0
Atascosa,1,U.S. House,28,REP,Under Votes,3,7,2,0,0,12,9,3
Atascosa,2,U.S. House,28,REP,Under Votes,1,3,0,0,0,4,3,1
Atascosa,3,U.S. House,28,REP,Under Votes,8,11,0,0,0,19,11,8
Atascosa,4,U.S. House,28,REP,Under Votes,4,3,1,0,0,8,4,4
Atascosa,5,U.S. House,28,REP,Under Votes,5,6,0,0,0,11,6,5
Atascosa,6,U.S. House,28,REP,Under Votes,2,1,0,0,0,3,1,2
Atascosa,7,U.S. House,28,REP,Under Votes,12,2,0,0,0,14,2,12
Atascosa,8,U.S. House,28,REP,Under Votes,2,3,0,0,0,5,3,2
Atascosa,9,U.S. House,28,REP,Under Votes,0,1,0,0,0,1,1,0
Atascosa,10,U.S. House,28,REP,Under Votes,5,2,0,0,0,7,2,5
Atascosa,11,U.S. House,28,REP,Under Votes,3,2,0,0,0,5,2,3
Atascosa,12,U.S. House,28,REP,Under Votes,4,4,0,0,0,8,4,4
Atascosa,13,U.S. House,28,REP,Under Votes,9,21,1,0,0,31,22,9
Atascosa,14,U.S. House,28,REP,Under Votes,0,4,0,0,0,4,4,0
Atascosa,15,U.S. House,28,REP,Under Votes,8,14,0,0,0,22,14,8
Atascosa,16,U.S. House,28,REP,Under Votes,2,1,0,0,0,3,1,2
Atascosa,17,U.S. House,28,REP,Under Votes,6,8,0,0,0,14,8,6
Atascosa,18,U.S. House,28,REP,Under Votes,12,12,0,0,0,24,12,12
Atascosa,19,U.S. House,28,REP,Under Votes,1,4,1,0,0,6,5,1
Atascosa,20,U.S. House,28,REP,Under Votes,22,38,2,0,0,62,40,22
Atascosa,21,U.S. House,28,REP,Under Votes,0,2,0,0,0,2,2,0
Atascosa,22,U.S. House,28,REP,Under Votes,21,9,0,0,0,30,9,21
Atascosa,23,U.S. House,28,REP,Under Votes,3,1,0,0,0,4,1,3
Atascosa,24,U.S. House,28,REP,Under Votes,6,11,0,0,0,17,11,6
Atascosa,1,Railroad Commissioner,,REP,"James ""Jim"" Wright",55,78,2,0,0,135,80,55
Atascosa,2,Railroad Commissioner,,REP,"James ""Jim"" Wright",48,20,2,0,0,70,22,48
Atascosa,3,Railroad Commissioner,,REP,"James ""Jim"" Wright",81,105,1,0,0,187,106,81
Atascosa,4,Railroad Commissioner,,REP,"James ""Jim"" Wright",18,3,1,0,0,22,4,18
Atascosa,5,Railroad Commissioner,,REP,"James ""Jim"" Wright",51,62,4,1,0,118,66,52
Atascosa,6,Railroad Commissioner,,REP,"James ""Jim"" Wright",7,18,1,0,0,26,19,7
Atascosa,7,Railroad Commissioner,,REP,"James ""Jim"" Wright",101,52,2,0,1,156,54,101
Atascosa,8,Railroad Commissioner,,REP,"James ""Jim"" Wright",37,23,0,0,0,60,23,37
Atascosa,9,Railroad Commissioner,,REP,"James ""Jim"" Wright",16,11,0,0,0,27,11,16
Atascosa,10,Railroad Commissioner,,REP,"James ""Jim"" Wright",92,33,0,0,0,125,33,92
Atascosa,11,Railroad Commissioner,,REP,"James ""Jim"" Wright",14,2,0,0,0,16,2,14
Atascosa,12,Railroad Commissioner,,REP,"James ""Jim"" Wright",58,37,1,0,0,96,38,58
Atascosa,13,Railroad Commissioner,,REP,"James ""Jim"" Wright",124,215,6,0,0,345,221,124
Atascosa,14,Railroad Commissioner,,REP,"James ""Jim"" Wright",10,47,2,1,0,60,49,11
Atascosa,15,Railroad Commissioner,,REP,"James ""Jim"" Wright",90,91,0,0,0,181,91,90
Atascosa,16,Railroad Commissioner,,REP,"James ""Jim"" Wright",11,14,3,0,0,28,17,11
Atascosa,17,Railroad Commissioner,,REP,"James ""Jim"" Wright",47,62,3,0,0,112,65,47
Atascosa,18,Railroad Commissioner,,REP,"James ""Jim"" Wright",104,83,3,0,0,190,86,104
Atascosa,19,Railroad Commissioner,,REP,"James ""Jim"" Wright",41,36,0,0,0,77,36,41
Atascosa,20,Railroad Commissioner,,REP,"James ""Jim"" Wright",300,405,10,0,0,715,415,300
Atascosa,21,Railroad Commissioner,,REP,"James ""Jim"" Wright",25,14,2,0,0,41,16,25
Atascosa,22,Railroad Commissioner,,REP,"James ""Jim"" Wright",75,65,2,0,0,142,67,75
Atascosa,23,Railroad Commissioner,,REP,"James ""Jim"" Wright",23,14,0,0,0,37,14,23
Atascosa,24,Railroad Commissioner,,REP,"James ""Jim"" Wright",67,81,0,0,0,148,81,67
Atascosa,1,Railroad Commissioner,,REP,Ryan Sitton,24,28,0,0,0,52,28,24
Atascosa,2,Railroad Commissioner,,REP,Ryan Sitton,18,14,1,0,0,33,15,18
Atascosa,3,Railroad Commissioner,,REP,Ryan Sitton,27,40,0,0,0,67,40,27
Atascosa,4,Railroad Commissioner,,REP,Ryan Sitton,8,6,0,0,0,14,6,8
Atascosa,5,Railroad Commissioner,,REP,Ryan Sitton,25,16,2,0,0,43,18,25
Atascosa,6,Railroad Commissioner,,REP,Ryan Sitton,1,0,0,0,0,1,0,1
Atascosa,7,Railroad Commissioner,,REP,Ryan Sitton,33,20,0,0,0,53,20,33
Atascosa,8,Railroad Commissioner,,REP,Ryan Sitton,7,11,0,0,0,18,11,7
Atascosa,9,Railroad Commissioner,,REP,Ryan Sitton,2,1,0,0,0,3,1,2
Atascosa,10,Railroad Commissioner,,REP,Ryan Sitton,37,23,1,0,0,61,24,37
Atascosa,11,Railroad Commissioner,,REP,Ryan Sitton,4,0,0,0,0,4,0,4
Atascosa,12,Railroad Commissioner,,REP,Ryan Sitton,44,18,0,0,0,62,18,44
Atascosa,13,Railroad Commissioner,,REP,Ryan Sitton,33,82,0,0,0,115,82,33
Atascosa,14,Railroad Commissioner,,REP,Ryan Sitton,7,13,0,0,0,20,13,7
Atascosa,15,Railroad Commissioner,,REP,Ryan Sitton,25,39,0,0,0,64,39,25
Atascosa,16,Railroad Commissioner,,REP,Ryan Sitton,2,12,0,0,0,14,12,2
Atascosa,17,Railroad Commissioner,,REP,Ryan Sitton,16,19,0,0,0,35,19,16
Atascosa,18,Railroad Commissioner,,REP,Ryan Sitton,24,25,0,0,0,49,25,24
Atascosa,19,Railroad Commissioner,,REP,Ryan Sitton,10,16,1,0,0,27,17,10
Atascosa,20,Railroad Commissioner,,REP,Ryan Sitton,84,160,5,0,0,249,165,84
Atascosa,21,Railroad Commissioner,,REP,Ryan Sitton,14,12,0,0,0,26,12,14
Atascosa,22,Railroad Commissioner,,REP,Ryan Sitton,36,33,0,0,0,69,33,36
Atascosa,23,Railroad Commissioner,,REP,Ryan Sitton,10,15,0,0,0,25,15,10
Atascosa,24,Railroad Commissioner,,REP,Ryan Sitton,29,37,2,0,0,68,39,29
Atascosa,1,Railroad Commissioner,,REP,Over Votes,0,0,0,0,0,0,0,0
Atascosa,2,Railroad Commissioner,,REP,Over Votes,0,0,0,0,0,0,0,0
Atascosa,3,Railroad Commissioner,,REP,Over Votes,0,0,0,0,0,0,0,0
Atascosa,4,Railroad Commissioner,,REP,Over Votes,0,0,0,0,0,0,0,0
Atascosa,5,Railroad Commissioner,,REP,Over Votes,0,0,0,0,0,0,0,0
Atascosa,6,Railroad Commissioner,,REP,Over Votes,0,0,0,0,0,0,0,0
Atascosa,7,Railroad Commissioner,,REP,Over Votes,0,0,0,0,0,0,0,0
Atascosa,8,Railroad Commissioner,,REP,Over Votes,0,0,0,0,0,0,0,0
Atascosa,9,Railroad Commissioner,,REP,Over Votes,0,0,0,0,0,0,0,0
Atascosa,10,Railroad Commissioner,,REP,Over Votes,0,0,0,0,0,0,0,0
Atascosa,11,Railroad Commissioner,,REP,Over Votes,0,0,0,0,0,0,0,0
Atascosa,12,Railroad Commissioner,,REP,Over Votes,0,0,0,0,0,0,0,0
Atascosa,13,Railroad Commissioner,,REP,Over Votes,0,0,0,0,0,0,0,0
Atascosa,14,Railroad Commissioner,,REP,Over Votes,0,0,0,0,0,0,0,0
Atascosa,15,Railroad Commissioner,,REP,Over Votes,0,0,0,0,0,0,0,0
Atascosa,16,Railroad Commissioner,,REP,Over Votes,0,0,0,0,0,0,0,0
Atascosa,17,Railroad Commissioner,,REP,Over Votes,0,0,0,0,0,0,0,0
Atascosa,18,Railroad Commissioner,,REP,Over Votes,0,0,0,0,0,0,0,0
Atascosa,19,Railroad Commissioner,,REP,Over Votes,0,0,0,0,0,0,0,0
Atascosa,20,Railroad Commissioner,,REP,Over Votes,0,0,0,0,0,0,0,0
Atascosa,21,Railroad Commissioner,,REP,Over Votes,0,0,0,0,0,0,0,0
Atascosa,22,Railroad Commissioner,,REP,Over Votes,0,0,0,0,0,0,0,0
Atascosa,23,Railroad Commissioner,,REP,Over Votes,0,0,0,0,0,0,0,0
Atascosa,24,Railroad Commissioner,,REP,Over Votes,0,0,0,0,0,0,0,0
Atascosa,1,Railroad Commissioner,,REP,Under Votes,1,1,0,0,0,2,1,1
Atascosa,2,Railroad Commissioner,,REP,Under Votes,3,2,0,0,0,5,2,3
Atascosa,3,Railroad Commissioner,,REP,Under Votes,7,9,0,0,0,16,9,7
Atascosa,4,Railroad Commissioner,,REP,Under Votes,2,1,0,0,0,3,1,2
Atascosa,5,Railroad Commissioner,,REP,Under Votes,7,3,0,0,0,10,3,7
Atascosa,6,Railroad Commissioner,,REP,Under Votes,0,0,0,0,0,0,0,0
Atascosa,7,Railroad Commissioner,,REP,Under Votes,8,5,0,0,0,13,5,8
Atascosa,8,Railroad Commissioner,,REP,Under Votes,0,6,0,0,0,6,6,0
Atascosa,9,Railroad Commissioner,,REP,Under Votes,1,0,0,0,0,1,0,1
Atascosa,10,Railroad Commissioner,,REP,Under Votes,2,1,0,0,0,3,1,2
Atascosa,11,Railroad Commissioner,,REP,Under Votes,0,1,0,0,0,1,1,0
Atascosa,12,Railroad Commissioner,,REP,Under Votes,4,2,0,0,0,6,2,4
Atascosa,13,Railroad Commissioner,,REP,Under Votes,7,18,1,0,0,26,19,7
Atascosa,14,Railroad Commissioner,,REP,Under Votes,0,1,0,0,0,1,1,0
Atascosa,15,Railroad Commissioner,,REP,Under Votes,8,9,0,0,0,17,9,8
Atascosa,16,Railroad Commissioner,,REP,Under Votes,2,1,0,0,0,3,1,2
Atascosa,17,Railroad Commissioner,,REP,Under Votes,5,3,0,0,0,8,3,5
Atascosa,18,Railroad Commissioner,,REP,Under Votes,10,12,1,0,0,23,13,10
Atascosa,19,Railroad Commissioner,,REP,Under Votes,2,1,0,0,0,3,1,2
Atascosa,20,Railroad Commissioner,,REP,Under Votes,24,24,1,0,0,49,25,24
Atascosa,21,Railroad Commissioner,,REP,Under Votes,0,1,0,0,0,1,1,0
Atascosa,22,Railroad Commissioner,,REP,Under Votes,12,9,0,0,0,21,9,12
Atascosa,23,Railroad Commissioner,,REP,Under Votes,1,0,0,0,0,1,0,1
Atascosa,24,Railroad Commissioner,,REP,Under Votes,9,8,0,0,0,17,8,9
Atascosa,1,State Senate,19,REP,"Peter P. ""Pete"" Flores",79,103,0,0,0,182,103,79
Atascosa,2,State Senate,19,REP,"Peter P. ""Pete"" Flores",65,34,3,0,0,102,37,65
Atascosa,3,State Senate,19,REP,"Peter P. ""Pete"" Flores",110,145,1,0,0,256,146,110
Atascosa,4,State Senate,19,REP,"Peter P. ""Pete"" Flores",0,0,0,0,0,0,0,0
Atascosa,5,State Senate,19,REP,"Peter P. ""Pete"" Flores",80,73,6,1,0,160,79,81
Atascosa,6,State Senate,19,REP,"Peter P. ""Pete"" Flores",0,0,0,0,0,0,0,0
Atascosa,7,State Senate,19,REP,"Peter P. ""Pete"" Flores",135,67,2,0,1,205,69,135
Atascosa,8,State Senate,19,REP,"Peter P. ""Pete"" Flores",42,38,0,0,0,80,38,42
Atascosa,9,State Senate,19,REP,"Peter P. ""Pete"" Flores",0,0,0,0,0,0,0,0
Atascosa,10,State Senate,19,REP,"Peter P. ""Pete"" Flores",128,54,1,0,0,183,55,128
Atascosa,11,State Senate,19,REP,"Peter P. ""Pete"" Flores",0,0,0,0,0,0,0,0
Atascosa,12,State Senate,19,REP,"Peter P. ""Pete"" Flores",102,54,1,0,0,157,55,102
Atascosa,13,State Senate,19,REP,"Peter P. ""Pete"" Flores",152,302,6,0,0,460,308,152
Atascosa,14,State Senate,19,REP,"Peter P. ""Pete"" Flores",17,57,2,1,0,77,59,18
Atascosa,15,State Senate,19,REP,"Peter P. ""Pete"" Flores",118,127,0,0,0,245,127,118
Atascosa,16,State Senate,19,REP,"Peter P. ""Pete"" Flores",14,27,3,0,0,44,30,14
Atascosa,17,State Senate,19,REP,"Peter P. ""Pete"" Flores",63,81,3,0,0,147,84,63
Atascosa,18,State Senate,19,REP,"Peter P. ""Pete"" Flores",125,113,4,0,0,242,117,125
Atascosa,19,State Senate,19,REP,"Peter P. ""Pete"" Flores",51,50,0,0,0,101,50,51
Atascosa,20,State Senate,19,REP,"Peter P. ""Pete"" Flores",388,561,14,0,0,963,575,388
Atascosa,21,State Senate,19,REP,"Peter P. ""Pete"" Flores",0,0,0,0,0,0,0,0
Atascosa,22,State Senate,19,REP,"Peter P. ""Pete"" Flores",107,101,2,0,0,210,103,107
Atascosa,23,State Senate,19,REP,"Peter P. ""Pete"" Flores",31,27,0,0,0,58,27,31
Atascosa,24,State Senate,19,REP,"Peter P. ""Pete"" Flores",100,115,2,0,0,217,117,100
Atascosa,1,State Senate,19,REP,Over Votes,0,0,0,0,0,0,0,0
Atascosa,2,State Senate,19,REP,Over Votes,0,0,0,0,0,0,0,0
Atascosa,3,State Senate,19,REP,Over Votes,0,0,0,0,0,0,0,0
Atascosa,4,State Senate,19,REP,Over Votes,0,0,0,0,0,0,0,0
Atascosa,5,State Senate,19,REP,Over Votes,0,0,0,0,0,0,0,0
Atascosa,6,State Senate,19,REP,Over Votes,0,0,0,0,0,0,0,0
Atascosa,7,State Senate,19,REP,Over Votes,0,0,0,0,0,0,0,0
Atascosa,8,State Senate,19,REP,Over Votes,0,0,0,0,0,0,0,0
Atascosa,9,State Senate,19,REP,Over Votes,0,0,0,0,0,0,0,0
Atascosa,10,State Senate,19,REP,Over Votes,0,0,0,0,0,0,0,0
Atascosa,11,State Senate,19,REP,Over Votes,0,0,0,0,0,0,0,0
Atascosa,12,State Senate,19,REP,Over Votes,0,0,0,0,0,0,0,0
Atascosa,13,State Senate,19,REP,Over Votes,0,0,0,0,0,0,0,0
Atascosa,14,State Senate,19,REP,Over Votes,0,0,0,0,0,0,0,0
Atascosa,15,State Senate,19,REP,Over Votes,0,0,0,0,0,0,0,0
Atascosa,16,State Senate,19,REP,Over Votes,0,0,0,0,0,0,0,0
Atascosa,17,State Senate,19,REP,Over Votes,0,0,0,0,0,0,0,0
Atascosa,18,State Senate,19,REP,Over Votes,0,0,0,0,0,0,0,0
Atascosa,19,State Senate,19,REP,Over Votes,0,0,0,0,0,0,0,0
Atascosa,20,State Senate,19,REP,Over Votes,0,0,0,0,0,0,0,0
Atascosa,21,State Senate,19,REP,Over Votes,0,0,0,0,0,0,0,0
Atascosa,22,State Senate,19,REP,Over Votes,0,0,0,0,0,0,0,0
Atascosa,23,State Senate,19,REP,Over Votes,0,0,0,0,0,0,0,0
Atascosa,24,State Senate,19,REP,Over Votes,0,0,0,0,0,0,0,0
Atascosa,1,State Senate,19,REP,Under Votes,1,4,2,0,0,7,6,1
Atascosa,2,State Senate,19,REP,Under Votes,4,2,0,0,0,6,2,4
Atascosa,3,State Senate,19,REP,Under Votes,5,9,0,0,0,14,9,5
Atascosa,4,State Senate,19,REP,Under Votes,0,0,0,0,0,0,0,0
Atascosa,5,State Senate,19,REP,Under Votes,3,8,0,0,0,11,8,3
Atascosa,6,State Senate,19,REP,Under Votes,0,0,0,0,0,0,0,0
Atascosa,7,State Senate,19,REP,Under Votes,7,10,0,0,0,17,10,7
Atascosa,8,State Senate,19,REP,Under Votes,2,2,0,0,0,4,2,2
Atascosa,9,State Senate,19,REP,Under Votes,0,0,0,0,0,0,0,0
Atascosa,10,State Senate,19,REP,Under Votes,3,3,0,0,0,6,3,3
Atascosa,11,State Senate,19,REP,Under Votes,0,0,0,0,0,0,0,0
Atascosa,12,State Senate,19,REP,Under Votes,4,3,0,0,0,7,3,4
Atascosa,13,State Senate,19,REP,Under Votes,12,13,1,0,0,26,14,12
Atascosa,14,State Senate,19,REP,Under Votes,0,4,0,0,0,4,4,0
Atascosa,15,State Senate,19,REP,Under Votes,5,12,0,0,0,17,12,5
Atascosa,16,State Senate,19,REP,Under Votes,1,0,0,0,0,1,0,1
Atascosa,17,State Senate,19,REP,Under Votes,5,3,0,0,0,8,3,5
Atascosa,18,State Senate,19,REP,Under Votes,13,7,0,0,0,20,7,13
Atascosa,19,State Senate,19,REP,Under Votes,2,3,1,0,0,6,4,2
Atascosa,20,State Senate,19,REP,Under Votes,20,28,2,0,0,50,30,20
Atascosa,21,State Senate,19,REP,Under Votes,0,0,0,0,0,0,0,0
Atascosa,22,State Senate,19,REP,Under Votes,16,6,0,0,0,22,6,16
Atascosa,23,State Senate,19,REP,Under Votes,3,2,0,0,0,5,2,3
Atascosa,24,State Senate,19,REP,Under Votes,5,11,0,0,0,16,11,5
Atascosa,1,State Senate,21,REP,Frank Pomeroy,0,0,0,0,0,0,0,0
Atascosa,2,State Senate,21,REP,Frank Pomeroy,0,0,0,0,0,0,0,0
Atascosa,3,State Senate,21,REP,Frank Pomeroy,0,0,0,0,0,0,0,0
Atascosa,4,State Senate,21,REP,Frank Pomeroy,23,7,1,0,0,31,8,23
Atascosa,5,State Senate,21,REP,Frank Pomeroy,0,0,0,0,0,0,0,0
Atascosa,6,State Senate,21,REP,Frank Pomeroy,8,18,1,0,0,27,19,8
Atascosa,7,State Senate,21,REP,Frank Pomeroy,0,0,0,0,0,0,0,0
Atascosa,8,State Senate,21,REP,Frank Pomeroy,0,0,0,0,0,0,0,0
Atascosa,9,State Senate,21,REP,Frank Pomeroy,19,11,0,0,0,30,11,19
Atascosa,10,State Senate,21,REP,Frank Pomeroy,0,0,0,0,0,0,0,0
Atascosa,11,State Senate,21,REP,Frank Pomeroy,14,1,0,0,0,15,1,14
Atascosa,12,State Senate,21,REP,Frank Pomeroy,0,0,0,0,0,0,0,0
Atascosa,13,State Senate,21,REP,Frank Pomeroy,0,0,0,0,0,0,0,0
Atascosa,14,State Senate,21,REP,Frank Pomeroy,0,0,0,0,0,0,0,0
Atascosa,15,State Senate,21,REP,Frank Pomeroy,0,0,0,0,0,0,0,0
Atascosa,16,State Senate,21,REP,Frank Pomeroy,0,0,0,0,0,0,0,0
Atascosa,17,State Senate,21,REP,Frank Pomeroy,0,0,0,0,0,0,0,0
Atascosa,18,State Senate,21,REP,Frank Pomeroy,0,0,0,0,0,0,0,0
Atascosa,19,State Senate,21,REP,Frank Pomeroy,0,0,0,0,0,0,0,0
Atascosa,20,State Senate,21,REP,Frank Pomeroy,0,0,0,0,0,0,0,0
Atascosa,21,State Senate,21,REP,Frank Pomeroy,39,26,2,0,0,67,28,39
Atascosa,22,State Senate,21,REP,Frank Pomeroy,0,0,0,0,0,0,0,0
Atascosa,23,State Senate,21,REP,Frank Pomeroy,0,0,0,0,0,0,0,0
Atascosa,24,State Senate,21,REP,Frank Pomeroy,0,0,0,0,0,0,0,0
Atascosa,1,State Senate,21,REP,Over Votes,0,0,0,0,0,0,0,0
Atascosa,2,State Senate,21,REP,Over Votes,0,0,0,0,0,0,0,0
Atascosa,3,State Senate,21,REP,Over Votes,0,0,0,0,0,0,0,0
Atascosa,4,State Senate,21,REP,Over Votes,0,0,0,0,0,0,0,0
Atascosa,5,State Senate,21,REP,Over Votes,0,0,0,0,0,0,0,0
Atascosa,6,State Senate,21,REP,Over Votes,0,0,0,0,0,0,0,0
Atascosa,7,State Senate,21,REP,Over Votes,0,0,0,0,0,0,0,0
Atascosa,8,State Senate,21,REP,Over Votes,0,0,0,0,0,0,0,0
Atascosa,9,State Senate,21,REP,Over Votes,0,0,0,0,0,0,0,0
Atascosa,10,State Senate,21,REP,Over Votes,0,0,0,0,0,0,0,0
Atascosa,11,State Senate,21,REP,Over Votes,0,0,0,0,0,0,0,0
Atascosa,12,State Senate,21,REP,Over Votes,0,0,0,0,0,0,0,0
Atascosa,13,State Senate,21,REP,Over Votes,0,0,0,0,0,0,0,0
Atascosa,14,State Senate,21,REP,Over Votes,0,0,0,0,0,0,0,0
Atascosa,15,State Senate,21,REP,Over Votes,0,0,0,0,0,0,0,0
Atascosa,16,State Senate,21,REP,Over Votes,0,0,0,0,0,0,0,0
Atascosa,17,State Senate,21,REP,Over Votes,0,0,0,0,0,0,0,0
Atascosa,18,State Senate,21,REP,Over Votes,0,0,0,0,0,0,0,0
Atascosa,19,State Senate,21,REP,Over Votes,0,0,0,0,0,0,0,0
Atascosa,20,State Senate,21,REP,Over Votes,0,0,0,0,0,0,0,0
Atascosa,21,State Senate,21,REP,Over Votes,0,0,0,0,0,0,0,0
Atascosa,22,State Senate,21,REP,Over Votes,0,0,0,0,0,0,0,0
Atascosa,23,State Senate,21,REP,Over Votes,0,0,0,0,0,0,0,0
Atascosa,24,State Senate,21,REP,Over Votes,0,0,0,0,0,0,0,0
Atascosa,1,State Senate,21,REP,Under Votes,0,0,0,0,0,0,0,0
Atascosa,2,State Senate,21,REP,Under Votes,0,0,0,0,0,0,0,0
Atascosa,3,State Senate,21,REP,Under Votes,0,0,0,0,0,0,0,0
Atascosa,4,State Senate,21,REP,Under Votes,5,3,0,0,0,8,3,5
Atascosa,5,State Senate,21,REP,Under Votes,0,0,0,0,0,0,0,0
Atascosa,6,State Senate,21,REP,Under Votes,0,0,0,0,0,0,0,0
Atascosa,7,State Senate,21,REP,Under Votes,0,0,0,0,0,0,0,0
Atascosa,8,State Senate,21,REP,Under Votes,0,0,0,0,0,0,0,0
Atascosa,9,State Senate,21,REP,Under Votes,0,1,0,0,0,1,1,0
Atascosa,10,State Senate,21,REP,Under Votes,0,0,0,0,0,0,0,0
Atascosa,11,State Senate,21,REP,Under Votes,4,2,0,0,0,6,2,4
Atascosa,12,State Senate,21,REP,Under Votes,0,0,0,0,0,0,0,0
Atascosa,13,State Senate,21,REP,Under Votes,0,0,0,0,0,0,0,0
Atascosa,14,State Senate,21,REP,Under Votes,0,0,0,0,0,0,0,0
Atascosa,15,State Senate,21,REP,Under Votes,0,0,0,0,0,0,0,0
Atascosa,16,State Senate,21,REP,Under Votes,0,0,0,0,0,0,0,0
Atascosa,17,State Senate,21,REP,Under Votes,0,0,0,0,0,0,0,0
Atascosa,18,State Senate,21,REP,Under Votes,0,0,0,0,0,0,0,0
Atascosa,19,State Senate,21,REP,Under Votes,0,0,0,0,0,0,0,0
Atascosa,20,State Senate,21,REP,Under Votes,0,0,0,0,0,0,0,0
Atascosa,21,State Senate,21,REP,Under Votes,0,1,0,0,0,1,1,0
Atascosa,22,State Senate,21,REP,Under Votes,0,0,0,0,0,0,0,0
Atascosa,23,State Senate,21,REP,Under Votes,0,0,0,0,0,0,0,0
Atascosa,24,State Senate,21,REP,Under Votes,0,0,0,0,0,0,0,0
Atascosa,1,State Representative,31,REP,Marian Knowlton,79,105,0,0,0,184,105,79
Atascosa,2,State Representative,31,REP,Marian Knowlton,65,32,3,0,0,100,35,65
Atascosa,3,State Representative,31,REP,Marian Knowlton,108,139,1,0,0,248,140,108
Atascosa,4,State Representative,31,REP,Marian Knowlton,23,6,1,0,0,30,7,23
Atascosa,5,State Representative,31,REP,Marian Knowlton,78,71,6,1,0,156,77,79
Atascosa,6,State Representative,31,REP,Marian Knowlton,7,18,1,0,0,26,19,7
Atascosa,7,State Representative,31,REP,Marian Knowlton,130,67,2,0,1,200,69,130
Atascosa,8,State Representative,31,REP,Marian Knowlton,42,38,0,0,0,80,38,42
Atascosa,9,State Representative,31,REP,Marian Knowlton,19,11,0,0,0,30,11,19
Atascosa,10,State Representative,31,REP,Marian Knowlton,122,56,1,0,0,179,57,122
Atascosa,11,State Representative,31,REP,Marian Knowlton,15,1,0,0,0,16,1,15
Atascosa,12,State Representative,31,REP,Marian Knowlton,101,50,1,0,0,152,51,101
Atascosa,13,State Representative,31,REP,Marian Knowlton,152,291,6,0,0,449,297,152
Atascosa,14,State Representative,31,REP,Marian Knowlton,17,60,2,1,0,80,62,18
Atascosa,15,State Representative,31,REP,Marian Knowlton,112,124,0,0,0,236,124,112
Atascosa,16,State Representative,31,REP,Marian Knowlton,13,25,0,0,0,38,25,13
Atascosa,17,State Representative,31,REP,Marian Knowlton,61,76,2,0,0,139,78,61
Atascosa,18,State Representative,31,REP,Marian Knowlton,127,106,4,0,0,237,110,127
Atascosa,19,State Representative,31,REP,Marian Knowlton,50,49,0,0,0,99,49,50
Atascosa,20,State Representative,31,REP,Marian Knowlton,375,537,15,0,0,927,552,375
Atascosa,21,State Representative,31,REP,Marian Knowlton,39,25,2,0,0,66,27,39
Atascosa,22,State Representative,31,REP,Marian Knowlton,103,98,2,0,0,203,100,103
Atascosa,23,State Representative,31,REP,Marian Knowlton,31,27,0,0,0,58,27,31
Atascosa,24,State Representative,31,REP,Marian Knowlton,99,113,2,0,0,214,115,99
Atascosa,1,State Representative,31,REP,Over Votes,0,0,0,0,0,0,0,0
Atascosa,2,State Representative,31,REP,Over Votes,0,0,0,0,0,0,0,0
Atascosa,3,State Representative,31,REP,Over Votes,0,0,0,0,0,0,0,0
Atascosa,4,State Representative,31,REP,Over Votes,0,0,0,0,0,0,0,0
Atascosa,5,State Representative,31,REP,Over Votes,0,0,0,0,0,0,0,0
Atascosa,6,State Representative,31,REP,Over Votes,0,0,0,0,0,0,0,0
Atascosa,7,State Representative,31,REP,Over Votes,0,0,0,0,0,0,0,0
Atascosa,8,State Representative,31,REP,Over Votes,0,0,0,0,0,0,0,0
Atascosa,9,State Representative,31,REP,Over Votes,0,0,0,0,0,0,0,0
Atascosa,10,State Representative,31,REP,Over Votes,0,0,0,0,0,0,0,0
Atascosa,11,State Representative,31,REP,Over Votes,0,0,0,0,0,0,0,0
Atascosa,12,State Representative,31,REP,Over Votes,0,0,0,0,0,0,0,0
Atascosa,13,State Representative,31,REP,Over Votes,0,0,0,0,0,0,0,0
Atascosa,14,State Representative,31,REP,Over Votes,0,0,0,0,0,0,0,0
Atascosa,15,State Representative,31,REP,Over Votes,0,0,0,0,0,0,0,0
Atascosa,16,State Representative,31,REP,Over Votes,0,0,0,0,0,0,0,0
Atascosa,17,State Representative,31,REP,Over Votes,0,0,0,0,0,0,0,0
Atascosa,18,State Representative,31,REP,Over Votes,0,0,0,0,0,0,0,0
Atascosa,19,State Representative,31,REP,Over Votes,0,0,0,0,0,0,0,0
Atascosa,20,State Representative,31,REP,Over Votes,0,0,0,0,0,0,0,0
Atascosa,21,State Representative,31,REP,Over Votes,0,0,0,0,0,0,0,0
Atascosa,22,State Representative,31,REP,Over Votes,0,0,0,0,0,0,0,0
Atascosa,23,State Representative,31,REP,Over Votes,0,0,0,0,0,0,0,0
Atascosa,24,State Representative,31,REP,Over Votes,0,0,0,0,0,0,0,0
Atascosa,1,State Representative,31,REP,Under Votes,1,2,2,0,0,5,4,1
Atascosa,2,State Representative,31,REP,Under Votes,4,4,0,0,0,8,4,4
Atascosa,3,State Representative,31,REP,Under Votes,7,15,0,0,0,22,15,7
Atascosa,4,State Representative,31,REP,Under Votes,5,4,0,0,0,9,4,5
Atascosa,5,State Representative,31,REP,Under Votes,5,10,0,0,0,15,10,5
Atascosa,6,State Representative,31,REP,Under Votes,1,0,0,0,0,1,0,1
Atascosa,7,State Representative,31,REP,Under Votes,12,10,0,0,0,22,10,12
Atascosa,8,State Representative,31,REP,Under Votes,2,2,0,0,0,4,2,2
Atascosa,9,State Representative,31,REP,Under Votes,0,1,0,0,0,1,1,0
Atascosa,10,State Representative,31,REP,Under Votes,9,1,0,0,0,10,1,9
Atascosa,11,State Representative,31,REP,Under Votes,3,2,0,0,0,5,2,3
Atascosa,12,State Representative,31,REP,Under Votes,5,7,0,0,0,12,7,5
Atascosa,13,State Representative,31,REP,Under Votes,12,24,1,0,0,37,25,12
Atascosa,14,State Representative,31,REP,Under Votes,0,1,0,0,0,1,1,0
Atascosa,15,State Representative,31,REP,Under Votes,11,15,0,0,0,26,15,11
Atascosa,16,State Representative,31,REP,Under Votes,2,2,3,0,0,7,5,2
Atascosa,17,State Representative,31,REP,Under Votes,7,8,1,0,0,16,9,7
Atascosa,18,State Representative,31,REP,Under Votes,11,14,0,0,0,25,14,11
Atascosa,19,State Representative,31,REP,Under Votes,3,4,1,0,0,8,5,3
Atascosa,20,State Representative,31,REP,Under Votes,33,52,1,0,0,86,53,33
Atascosa,21,State Representative,31,REP,Under Votes,0,2,0,0,0,2,2,0
Atascosa,22,State Representative,31,REP,Under Votes,20,9,0,0,0,29,9,20
Atascosa,23,State Representative,31,REP,Under Votes,3,2,0,0,0,5,2,3
Atascosa,24,State Representative,31,REP,Under Votes,6,13,0,0,0,19,13,6
Atascosa,1,President,,DEM,"Roque ""Rocky"" De La Fuente",0,0,0,0,0,0,0,0
Atascosa,2,President,,DEM,"Roque ""Rocky"" De La Fuente",0,0,0,0,0,0,0,0
Atascosa,3,President,,DEM,"Roque ""Rocky"" De La Fuente",1,1,0,0,0,2,1,1
Atascosa,4,President,,DEM,"Roque ""Rocky"" De La Fuente",0,0,0,0,0,0,0,0
Atascosa,5,President,,DEM,"Roque ""Rocky"" De La Fuente",1,0,0,0,0,1,0,1
Atascosa,6,President,,DEM,"Roque ""Rocky"" De La Fuente",0,0,0,0,0,0,0,0
Atascosa,7,President,,DEM,"Roque ""Rocky"" De La Fuente",0,0,0,0,0,0,0,0
Atascosa,8,President,,DEM,"Roque ""Rocky"" De La Fuente",1,1,0,0,0,2,1,1
Atascosa,9,President,,DEM,"Roque ""Rocky"" De La Fuente",0,0,0,0,0,0,0,0
Atascosa,10,President,,DEM,"Roque ""Rocky"" De La Fuente",2,1,0,0,0,3,1,2
Atascosa,11,President,,DEM,"Roque ""Rocky"" De La Fuente",0,0,0,0,0,0,0,0
Atascosa,12,President,,DEM,"Roque ""Rocky"" De La Fuente",0,0,0,0,0,0,0,0
Atascosa,13,President,,DEM,"Roque ""Rocky"" De La Fuente",0,0,0,0,0,0,0,0
Atascosa,14,President,,DEM,"Roque ""Rocky"" De La Fuente",0,2,0,0,0,2,2,0
Atascosa,15,President,,DEM,"Roque ""Rocky"" De La Fuente",2,0,0,0,0,2,0,2
Atascosa,16,President,,DEM,"Roque ""Rocky"" De La Fuente",0,0,0,0,0,0,0,0
Atascosa,17,President,,DEM,"Roque ""Rocky"" De La Fuente",7,0,1,0,0,8,1,7
Atascosa,18,President,,DEM,"Roque ""Rocky"" De La Fuente",2,1,0,0,0,3,1,2
Atascosa,19,President,,DEM,"Roque ""Rocky"" De La Fuente",0,0,0,0,0,0,0,0
Atascosa,20,President,,DEM,"Roque ""Rocky"" De La Fuente",1,0,0,0,0,1,0,1
Atascosa,21,President,,DEM,"Roque ""Rocky"" De La Fuente",0,0,0,0,0,0,0,0
Atascosa,22,President,,DEM,"Roque ""Rocky"" De La Fuente",0,0,0,0,0,0,0,0
Atascosa,23,President,,DEM,"Roque ""Rocky"" De La Fuente",0,0,0,0,0,0,0,0
Atascosa,24,President,,DEM,"Roque ""Rocky"" De La Fuente",0,1,0,0,0,1,1,0
Atascosa,1,President,,DEM,Marianne Williamson,0,0,0,0,0,0,0,0
Atascosa,2,President,,DEM,Marianne Williamson,0,0,0,0,0,0,0,0
Atascosa,3,President,,DEM,Marianne Williamson,0,1,0,0,0,1,1,0
Atascosa,4,President,,DEM,Marianne Williamson,0,0,0,0,0,0,0,0
Atascosa,5,President,,DEM,Marianne Williamson,0,0,0,0,0,0,0,0
Atascosa,6,President,,DEM,Marianne Williamson,0,0,0,0,0,0,0,0
Atascosa,7,President,,DEM,Marianne Williamson,0,0,0,0,0,0,0,0
Atascosa,8,President,,DEM,Marianne Williamson,0,0,0,0,0,0,0,0
Atascosa,9,President,,DEM,Marianne Williamson,0,0,0,0,0,0,0,0
Atascosa,10,President,,DEM,Marianne Williamson,1,0,0,0,0,1,0,1
Atascosa,11,President,,DEM,Marianne Williamson,0,0,0,0,0,0,0,0
Atascosa,12,President,,DEM,Marianne Williamson,0,0,0,0,0,0,0,0
Atascosa,13,President,,DEM,Marianne Williamson,1,0,0,0,0,1,0,1
Atascosa,14,President,,DEM,Marianne Williamson,0,0,0,0,0,0,0,0
Atascosa,15,President,,DEM,Marianne Williamson,0,0,0,0,0,0,0,0
Atascosa,16,President,,DEM,Marianne Williamson,1,0,0,0,0,1,0,1
Atascosa,17,President,,DEM,Marianne Williamson,0,1,0,0,0,1,1,0
Atascosa,18,President,,DEM,Marianne Williamson,2,1,0,0,0,3,1,2
Atascosa,19,President,,DEM,Marianne Williamson,0,0,0,0,0,0,0,0
Atascosa,20,President,,DEM,Marianne Williamson,0,0,0,0,0,0,0,0
Atascosa,21,President,,DEM,Marianne Williamson,0,0,0,0,0,0,0,0
Atascosa,22,President,,DEM,Marianne Williamson,0,1,0,0,0,1,1,0
Atascosa,23,President,,DEM,Marianne Williamson,0,0,0,0,0,0,0,0
Atascosa,24,President,,DEM,Marianne Williamson,0,0,0,0,0,0,0,0
Atascosa,1,President,,DEM,Michael R. Bloomberg,4,5,0,0,0,9,5,4
Atascosa,2,President,,DEM,Michael R. Bloomberg,1,6,4,0,0,11,10,1
Atascosa,3,President,,DEM,Michael R. Bloomberg,16,3,7,0,0,26,10,16
Atascosa,4,President,,DEM,Michael R. Bloomberg,2,0,0,0,0,2,0,2
Atascosa,5,President,,DEM,Michael R. Bloomberg,20,10,7,0,0,37,17,20
Atascosa,6,President,,DEM,Michael R. Bloomberg,0,0,0,0,0,0,0,0
Atascosa,7,President,,DEM,Michael R. Bloomberg,16,1,4,0,0,21,5,16
Atascosa,8,President,,DEM,Michael R. Bloomberg,9,7,1,0,0,17,8,9
Atascosa,9,President,,DEM,Michael R. Bloomberg,1,0,2,0,0,3,2,1
Atascosa,10,President,,DEM,Michael R. Bloomberg,18,5,2,0,0,25,7,18
Atascosa,11,President,,DEM,Michael R. Bloomberg,0,0,2,0,0,2,2,0
Atascosa,12,President,,DEM,Michael R. Bloomberg,4,6,6,0,0,16,12,4
Atascosa,13,President,,DEM,Michael R. Bloomberg,19,28,14,0,0,61,42,19
Atascosa,14,President,,DEM,Michael R. Bloomberg,5,7,1,0,0,13,8,5
Atascosa,15,President,,DEM,Michael R. Bloomberg,18,5,14,0,0,37,19,18
Atascosa,16,President,,DEM,Michael R. Bloomberg,0,3,2,0,0,5,5,0
Atascosa,17,President,,DEM,Michael R. Bloomberg,45,37,12,0,0,94,49,45
Atascosa,18,President,,DEM,Michael R. Bloomberg,43,17,10,0,0,70,27,43
Atascosa,19,President,,DEM,Michael R. Bloomberg,3,7,2,0,0,12,9,3
Atascosa,20,President,,DEM,Michael R. Bloomberg,27,25,10,0,0,62,35,27
Atascosa,21,President,,DEM,Michael R. Bloomberg,1,0,0,0,0,1,0,1
Atascosa,22,President,,DEM,Michael R. Bloomberg,7,7,3,0,0,17,10,7
Atascosa,23,President,,DEM,Michael R. Bloomberg,6,4,2,0,0,12,6,6
Atascosa,24,President,,DEM,Michael R. Bloomberg,9,16,7,0,0,32,23,9
Atascosa,1,President,,DEM,Pete Buttigieg,0,0,0,0,0,0,0,0
Atascosa,2,President,,DEM,Pete Buttigieg,0,0,1,0,0,1,1,0
Atascosa,3,President,,DEM,Pete Buttigieg,0,5,3,0,0,8,8,0
Atascosa,4,President,,DEM,Pete Buttigieg,0,0,0,0,0,0,0,0
Atascosa,5,President,,DEM,Pete Buttigieg,1,4,0,0,0,5,4,1
Atascosa,6,President,,DEM,Pete Buttigieg,0,1,2,0,0,3,3,0
Atascosa,7,President,,DEM,Pete Buttigieg,0,1,0,0,0,1,1,0
Atascosa,8,President,,DEM,Pete Buttigieg,0,2,0,0,0,2,2,0
Atascosa,9,President,,DEM,Pete Buttigieg,0,0,0,0,0,0,0,0
Atascosa,10,President,,DEM,Pete Buttigieg,0,2,1,0,0,3,3,0
Atascosa,11,President,,DEM,Pete Buttigieg,0,0,0,0,0,0,0,0
Atascosa,12,President,,DEM,Pete Buttigieg,1,2,1,0,0,4,3,1
Atascosa,13,President,,DEM,Pete Buttigieg,0,7,0,0,0,7,7,0
Atascosa,14,President,,DEM,Pete Buttigieg,0,0,1,0,0,1,1,0
Atascosa,15,President,,DEM,Pete Buttigieg,0,3,2,0,0,5,5,0
Atascosa,16,President,,DEM,Pete Buttigieg,0,0,0,0,0,0,0,0
Atascosa,17,President,,DEM,Pete Buttigieg,2,4,2,0,0,8,6,2
Atascosa,18,President,,DEM,Pete Buttigieg,2,0,1,0,0,3,1,2
Atascosa,19,President,,DEM,Pete Buttigieg,0,0,0,0,0,0,0,0
Atascosa,20,President,,DEM,Pete Buttigieg,3,9,3,0,0,15,12,3
Atascosa,21,President,,DEM,Pete Buttigieg,0,1,0,0,0,1,1,0
Atascosa,22,President,,DEM,Pete Buttigieg,0,2,0,0,0,2,2,0
Atascosa,23,President,,DEM,Pete Buttigieg,0,2,0,0,0,2,2,0
Atascosa,24,President,,DEM,Pete Buttigieg,0,4,1,0,0,5,5,0
Atascosa,1,President,,DEM,Bernie Sanders,9,3,0,0,0,12,3,9
Atascosa,2,President,,DEM,Bernie Sanders,17,5,3,0,0,25,8,17
Atascosa,3,President,,DEM,Bernie Sanders,25,18,1,0,0,44,19,25
Atascosa,4,President,,DEM,Bernie Sanders,4,1,0,0,0,5,1,4
Atascosa,5,President,,DEM,Bernie Sanders,17,15,1,0,0,33,16,17
Atascosa,6,President,,DEM,Bernie Sanders,1,0,0,0,0,1,0,1
Atascosa,7,President,,DEM,Bernie Sanders,25,10,4,1,0,40,14,26
Atascosa,8,President,,DEM,Bernie Sanders,9,11,0,0,0,20,11,9
Atascosa,9,President,,DEM,Bernie Sanders,1,0,0,0,0,1,0,1
Atascosa,10,President,,DEM,Bernie Sanders,26,10,1,0,0,37,11,26
Atascosa,11,President,,DEM,Bernie Sanders,0,0,0,0,0,0,0,0
Atascosa,12,President,,DEM,Bernie Sanders,19,10,2,1,0,32,12,20
Atascosa,13,President,,DEM,Bernie Sanders,37,27,7,0,0,71,34,37
Atascosa,14,President,,DEM,Bernie Sanders,13,4,1,0,0,18,5,13
Atascosa,15,President,,DEM,Bernie Sanders,40,12,7,0,1,60,19,40
Atascosa,16,President,,DEM,Bernie Sanders,3,2,0,0,0,5,2,3
Atascosa,17,President,,DEM,Bernie Sanders,67,34,5,1,0,107,39,68
Atascosa,18,President,,DEM,Bernie Sanders,45,8,3,0,0,56,11,45
Atascosa,19,President,,DEM,Bernie Sanders,4,7,3,0,0,14,10,4
Atascosa,20,President,,DEM,Bernie Sanders,35,30,1,0,0,66,31,35
Atascosa,21,President,,DEM,Bernie Sanders,2,0,0,0,0,2,0,2
Atascosa,22,President,,DEM,Bernie Sanders,5,4,0,0,0,9,4,5
Atascosa,23,President,,DEM,Bernie Sanders,15,5,2,0,0,22,7,15
Atascosa,24,President,,DEM,Bernie Sanders,42,15,3,1,0,61,18,43
Atascosa,1,President,,DEM,Andrew Yang,0,0,0,0,0,0,0,0
Atascosa,2,President,,DEM,Andrew Yang,1,0,0,0,0,1,0,1
Atascosa,3,President,,DEM,Andrew Yang,0,1,0,0,0,1,1,0
Atascosa,4,President,,DEM,Andrew Yang,0,0,0,0,0,0,0,0
Atascosa,5,President,,DEM,Andrew Yang,0,0,0,0,0,0,0,0
Atascosa,6,President,,DEM,Andrew Yang,0,0,0,0,0,0,0,0
Atascosa,7,President,,DEM,Andrew Yang,0,0,0,0,0,0,0,0
Atascosa,8,President,,DEM,Andrew Yang,0,0,0,0,0,0,0,0
Atascosa,9,President,,DEM,Andrew Yang,0,0,0,0,0,0,0,0
Atascosa,10,President,,DEM,Andrew Yang,0,0,0,0,0,0,0,0
Atascosa,11,President,,DEM,Andrew Yang,0,0,0,0,0,0,0,0
Atascosa,12,President,,DEM,Andrew Yang,0,0,0,0,0,0,0,0
Atascosa,13,President,,DEM,Andrew Yang,0,0,0,0,0,0,0,0
Atascosa,14,President,,DEM,Andrew Yang,0,0,0,0,0,0,0,0
Atascosa,15,President,,DEM,Andrew Yang,2,1,0,0,0,3,1,2
Atascosa,16,President,,DEM,Andrew Yang,0,0,0,0,0,0,0,0
Atascosa,17,President,,DEM,Andrew Yang,0,1,0,0,0,1,1,0
Atascosa,18,President,,DEM,Andrew Yang,1,1,0,0,0,2,1,1
Atascosa,19,President,,DEM,Andrew Yang,0,0,0,0,0,0,0,0
Atascosa,20,President,,DEM,Andrew Yang,0,0,0,0,0,0,0,0
Atascosa,21,President,,DEM,Andrew Yang,0,0,0,0,0,0,0,0
Atascosa,22,President,,DEM,Andrew Yang,0,0,0,0,0,0,0,0
Atascosa,23,President,,DEM,Andrew Yang,0,1,1,0,0,2,2,0
Atascosa,24,President,,DEM,Andrew Yang,1,0,0,0,0,1,0,1
Atascosa,1,President,,DEM,Cory Booker,0,0,0,0,0,0,0,0
Atascosa,2,President,,DEM,Cory Booker,0,0,0,0,0,0,0,0
Atascosa,3,President,,DEM,Cory Booker,0,0,0,0,0,0,0,0
Atascosa,4,President,,DEM,Cory Booker,0,0,0,0,0,0,0,0
Atascosa,5,President,,DEM,Cory Booker,0,0,0,0,0,0,0,0
Atascosa,6,President,,DEM,Cory Booker,0,0,0,0,0,0,0,0
Atascosa,7,President,,DEM,Cory Booker,0,0,0,0,0,0,0,0
Atascosa,8,President,,DEM,Cory Booker,0,0,0,0,0,0,0,0
Atascosa,9,President,,DEM,Cory Booker,0,0,0,0,0,0,0,0
Atascosa,10,President,,DEM,Cory Booker,0,0,0,0,0,0,0,0
Atascosa,11,President,,DEM,Cory Booker,0,0,0,0,0,0,0,0
Atascosa,12,President,,DEM,Cory Booker,0,0,0,0,0,0,0,0
Atascosa,13,President,,DEM,Cory Booker,0,0,0,0,0,0,0,0
Atascosa,14,President,,DEM,Cory Booker,0,0,0,0,0,0,0,0
Atascosa,15,President,,DEM,Cory Booker,0,0,0,0,0,0,0,0
Atascosa,16,President,,DEM,Cory Booker,0,0,0,0,0,0,0,0
Atascosa,17,President,,DEM,Cory Booker,0,0,1,0,0,1,1,0
Atascosa,18,President,,DEM,Cory Booker,1,0,0,0,0,1,0,1
Atascosa,19,President,,DEM,Cory Booker,0,0,0,0,0,0,0,0
Atascosa,20,President,,DEM,Cory Booker,0,0,0,0,0,0,0,0
Atascosa,21,President,,DEM,Cory Booker,0,0,0,0,0,0,0,0
Atascosa,22,President,,DEM,Cory Booker,0,0,0,0,0,0,0,0
Atascosa,23,President,,DEM,Cory Booker,0,0,0,0,0,0,0,0
Atascosa,24,President,,DEM,Cory Booker,0,0,0,0,0,0,0,0
Atascosa,1,President,,DEM,Robby Wells,0,0,0,0,0,0,0,0
Atascosa,2,President,,DEM,Robby Wells,0,0,0,0,0,0,0,0
Atascosa,3,President,,DEM,Robby Wells,0,1,0,0,0,1,1,0
Atascosa,4,President,,DEM,Robby Wells,0,0,0,0,0,0,0,0
Atascosa,5,President,,DEM,Robby Wells,0,0,0,0,0,0,0,0
Atascosa,6,President,,DEM,Robby Wells,0,0,0,0,0,0,0,0
Atascosa,7,President,,DEM,Robby Wells,0,0,0,0,0,0,0,0
Atascosa,8,President,,DEM,Robby Wells,0,0,0,0,0,0,0,0
Atascosa,9,President,,DEM,Robby Wells,0,0,0,0,0,0,0,0
Atascosa,10,President,,DEM,Robby Wells,0,0,0,0,0,0,0,0
Atascosa,11,President,,DEM,Robby Wells,0,0,0,0,0,0,0,0
Atascosa,12,President,,DEM,Robby Wells,0,0,0,0,0,0,0,0
Atascosa,13,President,,DEM,Robby Wells,0,0,0,0,0,0,0,0
Atascosa,14,President,,DEM,Robby Wells,0,0,0,0,0,0,0,0
Atascosa,15,President,,DEM,Robby Wells,0,0,0,0,0,0,0,0
Atascosa,16,President,,DEM,Robby Wells,0,0,0,0,0,0,0,0
Atascosa,17,President,,DEM,Robby Wells,1,1,0,0,0,2,1,1
Atascosa,18,President,,DEM,Robby Wells,1,0,0,0,0,1,0,1
Atascosa,19,President,,DEM,Robby Wells,0,0,0,0,0,0,0,0
Atascosa,20,President,,DEM,Robby Wells,0,1,0,0,0,1,1,0
Atascosa,21,President,,DEM,Robby Wells,0,0,0,0,0,0,0,0
Atascosa,22,President,,DEM,Robby Wells,0,0,0,0,0,0,0,0
Atascosa,23,President,,DEM,Robby Wells,0,0,0,0,0,0,0,0
Atascosa,24,President,,DEM,Robby Wells,0,0,0,0,0,0,0,0
Atascosa,1,President,,DEM,Julian Castro,1,1,1,0,0,3,2,1
Atascosa,2,President,,DEM,Julian Castro,0,0,0,0,0,0,0,0
Atascosa,3,President,,DEM,Julian Castro,2,0,1,0,0,3,1,2
Atascosa,4,President,,DEM,Julian Castro,0,0,1,0,0,1,1,0
Atascosa,5,President,,DEM,Julian Castro,4,0,2,0,0,6,2,4
Atascosa,6,President,,DEM,Julian Castro,0,0,0,0,0,0,0,0
Atascosa,7,President,,DEM,Julian Castro,1,3,0,0,0,4,3,1
Atascosa,8,President,,DEM,Julian Castro,2,2,0,0,0,4,2,2
Atascosa,9,President,,DEM,Julian Castro,0,0,0,0,0,0,0,0
Atascosa,10,President,,DEM,Julian Castro,2,0,0,0,0,2,0,2
Atascosa,11,President,,DEM,Julian Castro,0,0,0,0,0,0,0,0
Atascosa,12,President,,DEM,Julian Castro,2,0,0,0,0,2,0,2
Atascosa,13,President,,DEM,Julian Castro,6,8,1,0,0,15,9,6
Atascosa,14,President,,DEM,Julian Castro,2,3,2,0,0,7,5,2
Atascosa,15,President,,DEM,Julian Castro,11,2,1,0,0,14,3,11
Atascosa,16,President,,DEM,Julian Castro,1,0,0,0,0,1,0,1
Atascosa,17,President,,DEM,Julian Castro,19,9,0,0,0,28,9,19
Atascosa,18,President,,DEM,Julian Castro,30,9,0,0,0,39,9,30
Atascosa,19,President,,DEM,Julian Castro,0,5,0,0,0,5,5,0
Atascosa,20,President,,DEM,Julian Castro,4,3,1,0,0,8,4,4
Atascosa,21,President,,DEM,Julian Castro,0,0,0,0,0,0,0,0
Atascosa,22,President,,DEM,Julian Castro,0,0,0,0,0,0,0,0
Atascosa,23,President,,DEM,Julian Castro,0,0,0,0,0,0,0,0
Atascosa,24,President,,DEM,Julian Castro,0,0,0,0,0,0,0,0
Atascosa,1,President,,DEM,Deval Patrick,0,0,0,0,0,0,0,0
Atascosa,2,President,,DEM,Deval Patrick,0,0,0,0,0,0,0,0
Atascosa,3,President,,DEM,Deval Patrick,0,0,0,0,0,0,0,0
Atascosa,4,President,,DEM,Deval Patrick,0,0,0,0,0,0,0,0
Atascosa,5,President,,DEM,Deval Patrick,0,0,0,0,0,0,0,0
Atascosa,6,President,,DEM,Deval Patrick,0,0,0,0,0,0,0,0
Atascosa,7,President,,DEM,Deval Patrick,1,0,0,0,0,1,0,1
Atascosa,8,President,,DEM,Deval Patrick,0,0,0,0,0,0,0,0
Atascosa,9,President,,DEM,Deval Patrick,0,0,0,0,0,0,0,0
Atascosa,10,President,,DEM,Deval Patrick,0,0,0,0,0,0,0,0
Atascosa,11,President,,DEM,Deval Patrick,0,0,0,0,0,0,0,0
Atascosa,12,President,,DEM,Deval Patrick,0,0,0,0,0,0,0,0
Atascosa,13,President,,DEM,Deval Patrick,0,0,0,0,0,0,0,0
Atascosa,14,President,,DEM,Deval Patrick,0,0,0,0,0,0,0,0
Atascosa,15,President,,DEM,Deval Patrick,0,0,0,0,0,0,0,0
Atascosa,16,President,,DEM,Deval Patrick,0,0,0,0,0,0,0,0
Atascosa,17,President,,DEM,Deval Patrick,0,1,0,0,0,1,1,0
Atascosa,18,President,,DEM,Deval Patrick,1,0,0,0,0,1,0,1
Atascosa,19,President,,DEM,Deval Patrick,0,0,0,0,0,0,0,0
Atascosa,20,President,,DEM,Deval Patrick,0,0,0,0,0,0,0,0
Atascosa,21,President,,DEM,Deval Patrick,0,0,0,0,0,0,0,0
Atascosa,22,President,,DEM,Deval Patrick,0,0,0,0,0,0,0,0
Atascosa,23,President,,DEM,Deval Patrick,0,0,0,0,0,0,0,0
Atascosa,24,President,,DEM,Deval Patrick,0,0,0,0,0,0,0,0
Atascosa,1,President,,DEM,Tulsi Gabbard,0,0,0,0,0,0,0,0
Atascosa,2,President,,DEM,Tulsi Gabbard,0,0,0,0,0,0,0,0
Atascosa,3,President,,DEM,Tulsi Gabbard,1,0,0,0,0,1,0,1
Atascosa,4,President,,DEM,Tulsi Gabbard,0,0,0,0,0,0,0,0
Atascosa,5,President,,DEM,Tulsi Gabbard,0,0,0,0,0,0,0,0
Atascosa,6,President,,DEM,Tulsi Gabbard,0,0,0,0,0,0,0,0
Atascosa,7,President,,DEM,Tulsi Gabbard,0,1,0,0,0,1,1,0
Atascosa,8,President,,DEM,Tulsi Gabbard,0,0,0,0,0,0,0,0
Atascosa,9,President,,DEM,Tulsi Gabbard,0,0,0,0,0,0,0,0
Atascosa,10,President,,DEM,Tulsi Gabbard,0,1,0,0,0,1,1,0
Atascosa,11,President,,DEM,Tulsi Gabbard,0,0,0,0,0,0,0,0
Atascosa,12,President,,DEM,Tulsi Gabbard,0,0,0,0,0,0,0,0
Atascosa,13,President,,DEM,Tulsi Gabbard,2,0,0,0,0,2,0,2
Atascosa,14,President,,DEM,Tulsi Gabbard,0,0,0,0,0,0,0,0
Atascosa,15,President,,DEM,Tulsi Gabbard,0,0,0,0,0,0,0,0
Atascosa,16,President,,DEM,Tulsi Gabbard,0,0,0,0,0,0,0,0
Atascosa,17,President,,DEM,Tulsi Gabbard,1,0,0,0,0,1,0,1
Atascosa,18,President,,DEM,Tulsi Gabbard,0,1,0,0,0,1,1,0
Atascosa,19,President,,DEM,Tulsi Gabbard,0,0,0,0,0,0,0,0
Atascosa,20,President,,DEM,Tulsi Gabbard,0,0,0,0,0,0,0,0
Atascosa,21,President,,DEM,Tulsi Gabbard,0,0,0,0,0,0,0,0
Atascosa,22,President,,DEM,Tulsi Gabbard,0,0,0,0,0,0,0,0
Atascosa,23,President,,DEM,Tulsi Gabbard,0,0,0,0,0,0,0,0
Atascosa,24,President,,DEM,Tulsi Gabbard,3,0,0,0,0,3,0,3
Atascosa,1,President,,DEM,Elizabeth Warren,1,1,1,0,0,3,2,1
Atascosa,2,President,,DEM,Elizabeth Warren,5,0,2,0,0,7,2,5
Atascosa,3,President,,DEM,Elizabeth Warren,4,1,1,0,0,6,2,4
Atascosa,4,President,,DEM,Elizabeth Warren,1,0,0,0,0,1,0,1
Atascosa,5,President,,DEM,Elizabeth Warren,7,11,4,0,0,22,15,7
Atascosa,6,President,,DEM,Elizabeth Warren,0,0,0,0,0,0,0,0
Atascosa,7,President,,DEM,Elizabeth Warren,11,1,1,0,0,13,2,11
Atascosa,8,President,,DEM,Elizabeth Warren,3,0,0,0,0,3,0,3
Atascosa,9,President,,DEM,Elizabeth Warren,2,0,0,0,0,2,0,2
Atascosa,10,President,,DEM,Elizabeth Warren,8,3,1,0,0,12,4,8
Atascosa,11,President,,DEM,Elizabeth Warren,0,0,0,0,0,0,0,0
Atascosa,12,President,,DEM,Elizabeth Warren,6,1,0,0,0,7,1,6
Atascosa,13,President,,DEM,Elizabeth Warren,8,9,2,0,0,19,11,8
Atascosa,14,President,,DEM,Elizabeth Warren,2,2,2,0,0,6,4,2
Atascosa,15,President,,DEM,Elizabeth Warren,5,2,2,0,0,9,4,5
Atascosa,16,President,,DEM,Elizabeth Warren,2,1,0,0,0,3,1,2
Atascosa,17,President,,DEM,Elizabeth Warren,14,11,0,0,0,25,11,14
Atascosa,18,President,,DEM,Elizabeth Warren,9,5,1,0,0,15,6,9
Atascosa,19,President,,DEM,Elizabeth Warren,2,1,0,0,0,3,1,2
Atascosa,20,President,,DEM,Elizabeth Warren,10,15,2,0,0,27,17,10
Atascosa,21,President,,DEM,Elizabeth Warren,0,2,0,0,0,2,2,0
Atascosa,22,President,,DEM,Elizabeth Warren,2,0,0,0,0,2,0,2
Atascosa,23,President,,DEM,Elizabeth Warren,2,6,3,0,0,11,9,2
Atascosa,24,President,,DEM,Elizabeth Warren,3,6,0,0,0,9,6,3
Atascosa,1,President,,DEM,John K. Delaney,0,0,0,0,0,0,0,0
Atascosa,2,President,,DEM,John K. Delaney,0,0,0,0,0,0,0,0
Atascosa,3,President,,DEM,John K. Delaney,1,0,0,0,0,1,0,1
Atascosa,4,President,,DEM,John K. Delaney,0,0,0,0,0,0,0,0
Atascosa,5,President,,DEM,John K. Delaney,0,0,0,0,0,0,0,0
Atascosa,6,President,,DEM,John K. Delaney,0,0,0,0,0,0,0,0
Atascosa,7,President,,DEM,John K. Delaney,0,0,0,0,0,0,0,0
Atascosa,8,President,,DEM,John K. Delaney,0,0,0,0,0,0,0,0
Atascosa,9,President,,DEM,John K. Delaney,0,0,0,0,0,0,0,0
Atascosa,10,President,,DEM,John K. Delaney,0,0,0,0,0,0,0,0
Atascosa,11,President,,DEM,John K. Delaney,0,0,0,0,0,0,0,0
Atascosa,12,President,,DEM,John K. Delaney,0,0,0,0,0,0,0,0
Atascosa,13,President,,DEM,John K. Delaney,0,0,0,0,0,0,0,0
Atascosa,14,President,,DEM,John K. Delaney,0,0,0,0,0,0,0,0
Atascosa,15,President,,DEM,John K. Delaney,0,0,0,0,0,0,0,0
Atascosa,16,President,,DEM,John K. Delaney,0,0,0,0,0,0,0,0
Atascosa,17,President,,DEM,John K. Delaney,0,0,0,0,0,0,0,0
Atascosa,18,President,,DEM,John K. Delaney,3,0,0,0,0,3,0,3
Atascosa,19,President,,DEM,John K. Delaney,0,0,0,0,0,0,0,0
Atascosa,20,President,,DEM,John K. Delaney,2,0,0,0,0,2,0,2
Atascosa,21,President,,DEM,John K. Delaney,0,0,0,0,0,0,0,0
Atascosa,22,President,,DEM,John K. Delaney,0,0,0,0,0,0,0,0
Atascosa,23,President,,DEM,John K. Delaney,0,0,0,0,0,0,0,0
Atascosa,24,President,,DEM,John K. Delaney,0,0,0,0,0,0,0,0
Atascosa,1,President,,DEM,Tom Steyer,0,3,0,0,0,3,3,0
Atascosa,2,President,,DEM,Tom Steyer,0,2,0,0,0,2,2,0
Atascosa,3,President,,DEM,Tom Steyer,0,2,0,0,0,2,2,0
Atascosa,4,President,,DEM,Tom Steyer,0,0,0,0,0,0,0,0
Atascosa,5,President,,DEM,Tom Steyer,0,0,0,0,0,0,0,0
Atascosa,6,President,,DEM,Tom Steyer,0,0,0,0,0,0,0,0
Atascosa,7,President,,DEM,Tom Steyer,1,1,0,0,0,2,1,1
Atascosa,8,President,,DEM,Tom Steyer,2,2,0,0,0,4,2,2
Atascosa,9,President,,DEM,Tom Steyer,0,0,0,0,0,0,0,0
Atascosa,10,President,,DEM,Tom Steyer,2,0,0,0,0,2,0,2
Atascosa,11,President,,DEM,Tom Steyer,1,0,0,0,0,1,0,1
Atascosa,12,President,,DEM,Tom Steyer,2,0,1,0,0,3,1,2
Atascosa,13,President,,DEM,Tom Steyer,2,2,0,0,0,4,2,2
Atascosa,14,President,,DEM,Tom Steyer,1,0,0,0,0,1,0,1
Atascosa,15,President,,DEM,Tom Steyer,1,2,0,0,0,3,2,1
Atascosa,16,President,,DEM,Tom Steyer,0,2,0,0,0,2,2,0
Atascosa,17,President,,DEM,Tom Steyer,2,2,0,0,0,4,2,2
Atascosa,18,President,,DEM,Tom Steyer,4,4,1,0,0,9,5,4
Atascosa,19,President,,DEM,Tom Steyer,2,1,0,0,0,3,1,2
Atascosa,20,President,,DEM,Tom Steyer,2,1,0,0,0,3,1,2
Atascosa,21,President,,DEM,Tom Steyer,0,0,0,0,0,0,0,0
Atascosa,22,President,,DEM,Tom Steyer,0,1,1,0,0,2,2,0
Atascosa,23,President,,DEM,Tom Steyer,1,0,0,0,0,1,0,1
Atascosa,24,President,,DEM,Tom Steyer,0,0,0,0,0,0,0,0
Atascosa,1,President,,DEM,Michael Bennet,0,0,0,0,0,0,0,0
Atascosa,2,President,,DEM,Michael Bennet,0,0,0,0,0,0,0,0
Atascosa,3,President,,DEM,Michael Bennet,0,0,0,0,0,0,0,0
Atascosa,4,President,,DEM,Michael Bennet,0,0,0,0,0,0,0,0
Atascosa,5,President,,DEM,Michael Bennet,2,0,0,0,0,2,0,2
Atascosa,6,President,,DEM,Michael Bennet,0,0,0,0,0,0,0,0
Atascosa,7,President,,DEM,Michael Bennet,0,1,0,0,0,1,1,0
Atascosa,8,President,,DEM,Michael Bennet,0,0,0,0,0,0,0,0
Atascosa,9,President,,DEM,Michael Bennet,0,0,0,0,0,0,0,0
Atascosa,10,President,,DEM,Michael Bennet,1,0,0,0,0,1,0,1
Atascosa,11,President,,DEM,Michael Bennet,0,0,0,0,0,0,0,0
Atascosa,12,President,,DEM,Michael Bennet,0,0,0,0,0,0,0,0
Atascosa,13,President,,DEM,Michael Bennet,0,1,0,0,0,1,1,0
Atascosa,14,President,,DEM,Michael Bennet,0,0,0,0,0,0,0,0
Atascosa,15,President,,DEM,Michael Bennet,1,0,0,0,0,1,0,1
Atascosa,16,President,,DEM,Michael Bennet,1,0,0,0,0,1,0,1
Atascosa,17,President,,DEM,Michael Bennet,0,1,0,0,0,1,1,0
Atascosa,18,President,,DEM,Michael Bennet,3,1,0,0,0,4,1,3
Atascosa,19,President,,DEM,Michael Bennet,0,1,0,0,0,1,1,0
Atascosa,20,President,,DEM,Michael Bennet,0,1,0,0,0,1,1,0
Atascosa,21,President,,DEM,Michael Bennet,0,0,0,0,0,0,0,0
Atascosa,22,President,,DEM,Michael Bennet,0,0,0,0,0,0,0,0
Atascosa,23,President,,DEM,Michael Bennet,0,0,0,0,0,0,0,0
Atascosa,24,President,,DEM,Michael Bennet,0,0,0,0,0,0,0,0
Atascosa,1,President,,DEM,Amy Klobuchar,0,1,0,0,0,1,1,0
Atascosa,2,President,,DEM,Amy Klobuchar,0,0,0,0,0,0,0,0
Atascosa,3,President,,DEM,Amy Klobuchar,0,2,0,0,0,2,2,0
Atascosa,4,President,,DEM,Amy Klobuchar,0,0,0,0,0,0,0,0
Atascosa,5,President,,DEM,Amy Klobuchar,0,4,2,0,0,6,6,0
Atascosa,6,President,,DEM,Amy Klobuchar,0,0,0,0,0,0,0,0
Atascosa,7,President,,DEM,Amy Klobuchar,0,3,0,0,0,3,3,0
Atascosa,8,President,,DEM,Amy Klobuchar,0,0,0,0,0,0,0,0
Atascosa,9,President,,DEM,Amy Klobuchar,0,0,0,0,0,0,0,0
Atascosa,10,President,,DEM,Amy Klobuchar,1,0,0,0,0,1,0,1
Atascosa,11,President,,DEM,Amy Klobuchar,0,0,0,0,0,0,0,0
Atascosa,12,President,,DEM,Amy Klobuchar,0,2,1,0,0,3,3,0
Atascosa,13,President,,DEM,Amy Klobuchar,0,1,0,0,0,1,1,0
Atascosa,14,President,,DEM,Amy Klobuchar,0,0,0,0,0,0,0,0
Atascosa,15,President,,DEM,Amy Klobuchar,1,1,2,0,0,4,3,1
Atascosa,16,President,,DEM,Amy Klobuchar,0,0,0,0,0,0,0,0
Atascosa,17,President,,DEM,Amy Klobuchar,1,1,0,0,0,2,1,1
Atascosa,18,President,,DEM,Amy Klobuchar,1,1,1,0,0,3,2,1
Atascosa,19,President,,DEM,Amy Klobuchar,0,2,0,0,0,2,2,0
Atascosa,20,President,,DEM,Amy Klobuchar,1,4,0,0,0,5,4,1
Atascosa,21,President,,DEM,Amy Klobuchar,1,1,0,0,0,2,1,1
Atascosa,22,President,,DEM,Amy Klobuchar,0,1,0,0,0,1,1,0
Atascosa,23,President,,DEM,Amy Klobuchar,0,0,0,0,0,0,0,0
Atascosa,24,President,,DEM,Amy Klobuchar,0,3,2,0,0,5,5,0
Atascosa,1,President,,DEM,Joseph R. Biden,14,8,3,0,0,25,11,14
Atascosa,2,President,,DEM,Joseph R. Biden,26,2,3,0,0,31,5,26
Atascosa,3,President,,DEM,Joseph R. Biden,28,14,8,1,0,51,22,29
Atascosa,4,President,,DEM,Joseph R. Biden,6,0,1,0,0,7,1,6
Atascosa,5,President,,DEM,Joseph R. Biden,33,5,2,2,0,42,7,35
Atascosa,6,President,,DEM,Joseph R. Biden,1,1,0,0,0,2,1,1
Atascosa,7,President,,DEM,Joseph R. Biden,29,5,3,0,0,37,8,29
Atascosa,8,President,,DEM,Joseph R. Biden,7,1,0,0,0,8,1,7
Atascosa,9,President,,DEM,Joseph R. Biden,2,0,0,0,0,2,0,2
Atascosa,10,President,,DEM,Joseph R. Biden,25,15,1,0,0,41,16,25
Atascosa,11,President,,DEM,Joseph R. Biden,2,0,1,0,0,3,1,2
Atascosa,12,President,,DEM,Joseph R. Biden,24,8,4,0,0,36,12,24
Atascosa,13,President,,DEM,Joseph R. Biden,28,25,12,1,0,66,37,29
Atascosa,14,President,,DEM,Joseph R. Biden,8,1,0,0,0,9,1,8
Atascosa,15,President,,DEM,Joseph R. Biden,46,17,11,0,0,74,28,46
Atascosa,16,President,,DEM,Joseph R. Biden,6,2,1,0,0,9,3,6
Atascosa,17,President,,DEM,Joseph R. Biden,59,28,6,1,0,94,34,60
Atascosa,18,President,,DEM,Joseph R. Biden,39,7,7,0,0,53,14,39
Atascosa,19,President,,DEM,Joseph R. Biden,6,5,1,0,0,12,6,6
Atascosa,20,President,,DEM,Joseph R. Biden,62,36,7,1,0,106,43,63
Atascosa,21,President,,DEM,Joseph R. Biden,8,1,0,0,0,9,1,8
Atascosa,22,President,,DEM,Joseph R. Biden,14,1,1,0,0,16,2,14
Atascosa,23,President,,DEM,Joseph R. Biden,19,0,1,0,0,20,1,19
Atascosa,24,President,,DEM,Joseph R. Biden,42,11,0,0,0,53,11,42
Atascosa,1,President,,DEM,Over Votes,0,0,1,0,0,1,1,0
Atascosa,2,President,,DEM,Over Votes,0,0,1,0,0,1,1,0
Atascosa,3,President,,DEM,Over Votes,0,0,0,0,0,0,0,0
Atascosa,4,President,,DEM,Over Votes,0,0,0,0,0,0,0,0
Atascosa,5,President,,DEM,Over Votes,0,0,1,0,0,1,1,0
Atascosa,6,President,,DEM,Over Votes,0,0,0,0,0,0,0,0
Atascosa,7,President,,DEM,Over Votes,0,0,0,0,0,0,0,0
Atascosa,8,President,,DEM,Over Votes,0,0,0,0,0,0,0,0
Atascosa,9,President,,DEM,Over Votes,0,0,0,0,0,0,0,0
Atascosa,10,President,,DEM,Over Votes,0,0,0,0,0,0,0,0
Atascosa,11,President,,DEM,Over Votes,0,0,0,0,0,0,0,0
Atascosa,12,President,,DEM,Over Votes,0,0,0,0,0,0,0,0
Atascosa,13,President,,DEM,Over Votes,0,0,1,0,0,1,1,0
Atascosa,14,President,,DEM,Over Votes,0,0,0,0,0,0,0,0
Atascosa,15,President,,DEM,Over Votes,0,0,0,0,0,0,0,0
Atascosa,16,President,,DEM,Over Votes,0,0,0,0,0,0,0,0
Atascosa,17,President,,DEM,Over Votes,0,0,0,0,0,0,0,0
Atascosa,18,President,,DEM,Over Votes,0,0,0,0,0,0,0,0
Atascosa,19,President,,DEM,Over Votes,0,0,0,0,0,0,0,0
Atascosa,20,President,,DEM,Over Votes,0,0,1,0,0,1,1,0
Atascosa,21,President,,DEM,Over Votes,0,0,0,0,0,0,0,0
Atascosa,22,President,,DEM,Over Votes,0,0,0,0,0,0,0,0
Atascosa,23,President,,DEM,Over Votes,0,0,0,0,0,0,0,0
Atascosa,24,President,,DEM,Over Votes,0,0,0,0,0,0,0,0
Atascosa,1,President,,DEM,Under Votes,0,0,0,0,0,0,0,0
Atascosa,2,President,,DEM,Under Votes,0,0,0,0,0,0,0,0
Atascosa,3,President,,DEM,Under Votes,3,2,0,0,0,5,2,3
Atascosa,4,President,,DEM,Under Votes,1,0,0,0,0,1,0,1
Atascosa,5,President,,DEM,Under Votes,0,0,0,0,0,0,0,0
Atascosa,6,President,,DEM,Under Votes,0,0,0,0,0,0,0,0
Atascosa,7,President,,DEM,Under Votes,1,0,1,0,0,2,1,1
Atascosa,8,President,,DEM,Under Votes,3,0,0,0,0,3,0,3
Atascosa,9,President,,DEM,Under Votes,0,0,0,0,0,0,0,0
Atascosa,10,President,,DEM,Under Votes,1,1,0,0,0,2,1,1
Atascosa,11,President,,DEM,Under Votes,0,0,0,0,0,0,0,0
Atascosa,12,President,,DEM,Under Votes,1,0,1,0,0,2,1,1
Atascosa,13,President,,DEM,Under Votes,2,4,0,0,0,6,4,2
Atascosa,14,President,,DEM,Under Votes,5,3,0,0,0,8,3,5
Atascosa,15,President,,DEM,Under Votes,3,2,2,0,0,7,4,3
Atascosa,16,President,,DEM,Under Votes,0,2,0,0,0,2,2,0
Atascosa,17,President,,DEM,Under Votes,12,9,1,0,0,22,10,12
Atascosa,18,President,,DEM,Under Votes,30,9,2,0,0,41,11,30
Atascosa,19,President,,DEM,Under Votes,0,1,0,0,0,1,1,0
Atascosa,20,President,,DEM,Under Votes,3,1,0,0,0,4,1,3
Atascosa,21,President,,DEM,Under Votes,0,0,0,0,0,0,0,0
Atascosa,22,President,,DEM,Under Votes,0,0,0,0,0,0,0,0
Atascosa,23,President,,DEM,Under Votes,1,0,0,0,0,1,0,1
Atascosa,24,President,,DEM,Under Votes,0,1,0,0,0,1,1,0
Atascosa,1,U.S. Senate,,DEM,Mary (MJ) Hegar,2,5,0,0,0,7,5,2
Atascosa,2,U.S. Senate,,DEM,Mary (MJ) Hegar,11,3,6,0,0,20,9,11
Atascosa,3,U.S. Senate,,DEM,Mary (MJ) Hegar,11,12,3,0,0,26,15,11
Atascosa,4,U.S. Senate,,DEM,Mary (MJ) Hegar,2,0,0,0,0,2,0,2
Atascosa,5,U.S. Senate,,DEM,Mary (MJ) Hegar,11,14,2,2,0,29,16,13
Atascosa,6,U.S. Senate,,DEM,Mary (MJ) Hegar,0,0,0,0,0,0,0,0
Atascosa,7,U.S. Senate,,DEM,Mary (MJ) Hegar,10,6,2,0,0,18,8,10
Atascosa,8,U.S. Senate,,DEM,Mary (MJ) Hegar,5,6,0,0,0,11,6,5
Atascosa,9,U.S. Senate,,DEM,Mary (MJ) Hegar,0,0,0,0,0,0,0,0
Atascosa,10,U.S. Senate,,DEM,Mary (MJ) Hegar,6,6,2,0,0,14,8,6
Atascosa,11,U.S. Senate,,DEM,Mary (MJ) Hegar,0,0,0,0,0,0,0,0
Atascosa,12,U.S. Senate,,DEM,Mary (MJ) Hegar,13,6,2,0,0,21,8,13
Atascosa,13,U.S. Senate,,DEM,Mary (MJ) Hegar,17,12,8,0,0,37,20,17
Atascosa,14,U.S. Senate,,DEM,Mary (MJ) Hegar,3,2,1,0,0,6,3,3
Atascosa,15,U.S. Senate,,DEM,Mary (MJ) Hegar,15,12,4,0,0,31,16,15
Atascosa,16,U.S. Senate,,DEM,Mary (MJ) Hegar,1,3,1,0,0,5,4,1
Atascosa,17,U.S. Senate,,DEM,Mary (MJ) Hegar,26,21,2,1,0,50,23,27
Atascosa,18,U.S. Senate,,DEM,Mary (MJ) Hegar,17,10,7,0,0,34,17,17
Atascosa,19,U.S. Senate,,DEM,Mary (MJ) Hegar,2,5,0,0,0,7,5,2
Atascosa,20,U.S. Senate,,DEM,Mary (MJ) Hegar,28,38,5,0,0,71,43,28
Atascosa,21,U.S. Senate,,DEM,Mary (MJ) Hegar,1,3,0,0,0,4,3,1
Atascosa,22,U.S. Senate,,DEM,Mary (MJ) Hegar,6,7,0,0,0,13,7,6
Atascosa,23,U.S. Senate,,DEM,Mary (MJ) Hegar,3,1,2,0,0,6,3,3
Atascosa,24,U.S. Senate,,DEM,Mary (MJ) Hegar,20,19,5,0,0,44,24,20
Atascosa,1,U.S. Senate,,DEM,Victor Hugo Harris,0,3,1,0,0,4,4,0
Atascosa,2,U.S. Senate,,DEM,Victor Hugo Harris,2,0,0,0,0,2,0,2
Atascosa,3,U.S. Senate,,DEM,Victor Hugo Harris,7,1,2,0,0,10,3,7
Atascosa,4,U.S. Senate,,DEM,Victor Hugo Harris,0,0,0,0,0,0,0,0
Atascosa,5,U.S. Senate,,DEM,Victor Hugo Harris,4,1,0,0,0,5,1,4
Atascosa,6,U.S. Senate,,DEM,Victor Hugo Harris,0,0,0,0,0,0,0,0
Atascosa,7,U.S. Senate,,DEM,Victor Hugo Harris,7,1,0,0,0,8,1,7
Atascosa,8,U.S. Senate,,DEM,Victor Hugo Harris,4,0,0,0,0,4,0,4
Atascosa,9,U.S. Senate,,DEM,Victor Hugo Harris,0,0,0,0,0,0,0,0
Atascosa,10,U.S. Senate,,DEM,Victor Hugo Harris,7,0,0,0,0,7,0,7
Atascosa,11,U.S. Senate,,DEM,Victor Hugo Harris,0,0,1,0,0,1,1,0
Atascosa,12,U.S. Senate,,DEM,Victor Hugo Harris,0,1,0,0,0,1,1,0
Atascosa,13,U.S. Senate,,DEM,Victor Hugo Harris,6,4,2,0,0,12,6,6
Atascosa,14,U.S. Senate,,DEM,Victor Hugo Harris,1,1,0,0,0,2,1,1
Atascosa,15,U.S. Senate,,DEM,Victor Hugo Harris,5,3,5,0,0,13,8,5
Atascosa,16,U.S. Senate,,DEM,Victor Hugo Harris,0,0,0,0,0,0,0,0
Atascosa,17,U.S. Senate,,DEM,Victor Hugo Harris,10,5,1,0,0,16,6,10
Atascosa,18,U.S. Senate,,DEM,Victor Hugo Harris,15,2,4,0,0,21,6,15
Atascosa,19,U.S. Senate,,DEM,Victor Hugo Harris,0,1,0,0,0,1,1,0
Atascosa,20,U.S. Senate,,DEM,Victor Hugo Harris,8,3,2,0,0,13,5,8
Atascosa,21,U.S. Senate,,DEM,Victor Hugo Harris,0,0,0,0,0,0,0,0
Atascosa,22,U.S. Senate,,DEM,Victor Hugo Harris,1,0,0,0,0,1,0,1
Atascosa,23,U.S. Senate,,DEM,Victor Hugo Harris,2,1,0,0,0,3,1,2
Atascosa,24,U.S. Senate,,DEM,Victor Hugo Harris,4,2,0,0,0,6,2,4
Atascosa,1,U.S. Senate,,DEM,Amanda K. Edwards,3,3,0,0,0,6,3,3
Atascosa,2,U.S. Senate,,DEM,Amanda K. Edwards,4,3,1,0,0,8,4,4
Atascosa,3,U.S. Senate,,DEM,Amanda K. Edwards,3,5,2,0,0,10,7,3
Atascosa,4,U.S. Senate,,DEM,Amanda K. Edwards,2,0,0,0,0,2,0,2
Atascosa,5,U.S. Senate,,DEM,Amanda K. Edwards,3,5,0,0,0,8,5,3
Atascosa,6,U.S. Senate,,DEM,Amanda K. Edwards,0,0,0,0,0,0,0,0
Atascosa,7,U.S. Senate,,DEM,Amanda K. Edwards,9,2,0,1,0,12,2,10
Atascosa,8,U.S. Senate,,DEM,Amanda K. Edwards,4,1,0,0,0,5,1,4
Atascosa,9,U.S. Senate,,DEM,Amanda K. Edwards,0,0,0,0,0,0,0,0
Atascosa,10,U.S. Senate,,DEM,Amanda K. Edwards,5,4,0,0,0,9,4,5
Atascosa,11,U.S. Senate,,DEM,Amanda K. Edwards,1,0,0,0,0,1,0,1
Atascosa,12,U.S. Senate,,DEM,Amanda K. Edwards,3,2,2,0,0,7,4,3
Atascosa,13,U.S. Senate,,DEM,Amanda K. Edwards,2,4,4,0,0,10,8,2
Atascosa,14,U.S. Senate,,DEM,Amanda K. Edwards,4,0,1,0,0,5,1,4
Atascosa,15,U.S. Senate,,DEM,Amanda K. Edwards,7,3,4,0,0,14,7,7
Atascosa,16,U.S. Senate,,DEM,Amanda K. Edwards,1,0,0,0,0,1,0,1
Atascosa,17,U.S. Senate,,DEM,Amanda K. Edwards,18,8,0,0,0,26,8,18
Atascosa,18,U.S. Senate,,DEM,Amanda K. Edwards,11,4,0,0,0,15,4,11
Atascosa,19,U.S. Senate,,DEM,Amanda K. Edwards,3,0,1,0,0,4,1,3
Atascosa,20,U.S. Senate,,DEM,Amanda K. Edwards,15,7,8,0,0,30,15,15
Atascosa,21,U.S. Senate,,DEM,Amanda K. Edwards,4,0,0,0,0,4,0,4
Atascosa,22,U.S. Senate,,DEM,Amanda K. Edwards,1,0,0,0,0,1,0,1
Atascosa,23,U.S. Senate,,DEM,Amanda K. Edwards,2,3,0,0,0,5,3,2
Atascosa,24,U.S. Senate,,DEM,Amanda K. Edwards,7,6,0,0,0,13,6,7
Atascosa,1,U.S. Senate,,DEM,D. R. Hunter,1,0,0,0,0,1,0,1
Atascosa,2,U.S. Senate,,DEM,D. R. Hunter,1,0,0,0,0,1,0,1
Atascosa,3,U.S. Senate,,DEM,D. R. Hunter,1,0,1,1,0,3,1,2
Atascosa,4,U.S. Senate,,DEM,D. R. Hunter,0,0,0,0,0,0,0,0
Atascosa,5,U.S. Senate,,DEM,D. R. Hunter,1,0,0,0,0,1,0,1
Atascosa,6,U.S. Senate,,DEM,D. R. Hunter,0,1,0,0,0,1,1,0
Atascosa,7,U.S. Senate,,DEM,D. R. Hunter,1,2,0,0,0,3,2,1
Atascosa,8,U.S. Senate,,DEM,D. R. Hunter,1,0,0,0,0,1,0,1
Atascosa,9,U.S. Senate,,DEM,D. R. Hunter,0,0,0,0,0,0,0,0
Atascosa,10,U.S. Senate,,DEM,D. R. Hunter,1,1,0,0,0,2,1,1
Atascosa,11,U.S. Senate,,DEM,D. R. Hunter,0,0,0,0,0,0,0,0
Atascosa,12,U.S. Senate,,DEM,D. R. Hunter,1,0,1,0,0,2,1,1
Atascosa,13,U.S. Senate,,DEM,D. R. Hunter,2,0,1,0,0,3,1,2
Atascosa,14,U.S. Senate,,DEM,D. R. Hunter,1,2,0,0,0,3,2,1
Atascosa,15,U.S. Senate,,DEM,D. R. Hunter,0,1,0,0,0,1,1,0
Atascosa,16,U.S. Senate,,DEM,D. R. Hunter,0,0,0,0,0,0,0,0
Atascosa,17,U.S. Senate,,DEM,D. R. Hunter,5,3,0,0,0,8,3,5
Atascosa,18,U.S. Senate,,DEM,D. R. Hunter,3,1,0,0,0,4,1,3
Atascosa,19,U.S. Senate,,DEM,D. R. Hunter,1,0,0,0,0,1,0,1
Atascosa,20,U.S. Senate,,DEM,D. R. Hunter,1,1,0,0,0,2,1,1
Atascosa,21,U.S. Senate,,DEM,D. R. Hunter,0,0,0,0,0,0,0,0
Atascosa,22,U.S. Senate,,DEM,D. R. Hunter,1,0,0,0,0,1,0,1
Atascosa,23,U.S. Senate,,DEM,D. R. Hunter,0,1,0,0,0,1,1,0
Atascosa,24,U.S. Senate,,DEM,D. R. Hunter,1,0,0,0,0,1,0,1
Atascosa,1,U.S. Senate,,DEM,Adrian Ocegueda,0,0,0,0,0,0,0,0
Atascosa,2,U.S. Senate,,DEM,Adrian Ocegueda,0,0,0,0,0,0,0,0
Atascosa,3,U.S. Senate,,DEM,Adrian Ocegueda,3,0,0,0,0,3,0,3
Atascosa,4,U.S. Senate,,DEM,Adrian Ocegueda,0,0,0,0,0,0,0,0
Atascosa,5,U.S. Senate,,DEM,Adrian Ocegueda,5,2,2,0,0,9,4,5
Atascosa,6,U.S. Senate,,DEM,Adrian Ocegueda,0,0,0,0,0,0,0,0
Atascosa,7,U.S. Senate,,DEM,Adrian Ocegueda,2,0,0,0,0,2,0,2
Atascosa,8,U.S. Senate,,DEM,Adrian Ocegueda,0,1,0,0,0,1,1,0
Atascosa,9,U.S. Senate,,DEM,Adrian Ocegueda,1,0,0,0,0,1,0,1
Atascosa,10,U.S. Senate,,DEM,Adrian Ocegueda,6,0,0,0,0,6,0,6
Atascosa,11,U.S. Senate,,DEM,Adrian Ocegueda,0,0,0,0,0,0,0,0
Atascosa,12,U.S. Senate,,DEM,Adrian Ocegueda,4,0,0,0,0,4,0,4
Atascosa,13,U.S. Senate,,DEM,Adrian Ocegueda,3,2,0,0,0,5,2,3
Atascosa,14,U.S. Senate,,DEM,Adrian Ocegueda,0,0,0,0,0,0,0,0
Atascosa,15,U.S. Senate,,DEM,Adrian Ocegueda,1,2,1,0,0,4,3,1
Atascosa,16,U.S. Senate,,DEM,Adrian Ocegueda,0,0,0,0,0,0,0,0
Atascosa,17,U.S. Senate,,DEM,Adrian Ocegueda,5,3,0,0,0,8,3,5
Atascosa,18,U.S. Senate,,DEM,Adrian Ocegueda,1,1,0,0,0,2,1,1
Atascosa,19,U.S. Senate,,DEM,Adrian Ocegueda,0,1,0,0,0,1,1,0
Atascosa,20,U.S. Senate,,DEM,Adrian Ocegueda,4,1,0,0,0,5,1,4
Atascosa,21,U.S. Senate,,DEM,Adrian Ocegueda,1,1,0,0,0,2,1,1
Atascosa,22,U.S. Senate,,DEM,Adrian Ocegueda,3,0,0,0,0,3,0,3
Atascosa,23,U.S. Senate,,DEM,Adrian Ocegueda,0,2,1,0,0,3,3,0
Atascosa,24,U.S. Senate,,DEM,Adrian Ocegueda,5,2,0,0,0,7,2,5
Atascosa,1,U.S. Senate,,DEM,Chris Bell,1,1,0,0,0,2,1,1
Atascosa,2,U.S. Senate,,DEM,Chris Bell,1,0,2,0,0,3,2,1
Atascosa,3,U.S. Senate,,DEM,Chris Bell,5,3,0,0,0,8,3,5
Atascosa,4,U.S. Senate,,DEM,Chris Bell,0,0,0,0,0,0,0,0
Atascosa,5,U.S. Senate,,DEM,Chris Bell,3,1,2,0,0,6,3,3
Atascosa,6,U.S. Senate,,DEM,Chris Bell,0,0,0,0,0,0,0,0
Atascosa,7,U.S. Senate,,DEM,Chris Bell,4,1,0,0,0,5,1,4
Atascosa,8,U.S. Senate,,DEM,Chris Bell,2,0,0,0,0,2,0,2
Atascosa,9,U.S. Senate,,DEM,Chris Bell,1,0,2,0,0,3,2,1
Atascosa,10,U.S. Senate,,DEM,Chris Bell,4,2,1,0,0,7,3,4
Atascosa,11,U.S. Senate,,DEM,Chris Bell,0,0,0,0,0,0,0,0
Atascosa,12,U.S. Senate,,DEM,Chris Bell,5,2,0,0,0,7,2,5
Atascosa,13,U.S. Senate,,DEM,Chris Bell,5,6,1,0,0,12,7,5
Atascosa,14,U.S. Senate,,DEM,Chris Bell,1,1,0,0,0,2,1,1
Atascosa,15,U.S. Senate,,DEM,Chris Bell,2,3,4,0,0,9,7,2
Atascosa,16,U.S. Senate,,DEM,Chris Bell,0,0,0,0,0,0,0,0
Atascosa,17,U.S. Senate,,DEM,Chris Bell,8,1,1,0,0,10,2,8
Atascosa,18,U.S. Senate,,DEM,Chris Bell,2,1,1,0,0,4,2,2
Atascosa,19,U.S. Senate,,DEM,Chris Bell,1,1,0,0,0,2,1,1
Atascosa,20,U.S. Senate,,DEM,Chris Bell,7,6,1,0,0,14,7,7
Atascosa,21,U.S. Senate,,DEM,Chris Bell,0,0,0,0,0,0,0,0
Atascosa,22,U.S. Senate,,DEM,Chris Bell,0,2,0,0,0,2,2,0
Atascosa,23,U.S. Senate,,DEM,Chris Bell,3,1,0,0,0,4,1,3
Atascosa,24,U.S. Senate,,DEM,Chris Bell,3,1,2,0,0,6,3,3
Atascosa,1,U.S. Senate,,DEM,"Jack Daniel Foster, Jr.",0,0,0,0,0,0,0,0
Atascosa,2,U.S. Senate,,DEM,"Jack Daniel Foster, Jr.",0,0,0,0,0,0,0,0
Atascosa,3,U.S. Senate,,DEM,"Jack Daniel Foster, Jr.",1,2,0,0,0,3,2,1
Atascosa,4,U.S. Senate,,DEM,"Jack Daniel Foster, Jr.",0,0,0,0,0,0,0,0
Atascosa,5,U.S. Senate,,DEM,"Jack Daniel Foster, Jr.",0,1,0,0,0,1,1,0
Atascosa,6,U.S. Senate,,DEM,"Jack Daniel Foster, Jr.",0,0,0,0,0,0,0,0
Atascosa,7,U.S. Senate,,DEM,"Jack Daniel Foster, Jr.",3,0,0,0,0,3,0,3
Atascosa,8,U.S. Senate,,DEM,"Jack Daniel Foster, Jr.",1,1,0,0,0,2,1,1
Atascosa,9,U.S. Senate,,DEM,"Jack Daniel Foster, Jr.",2,0,0,0,0,2,0,2
Atascosa,10,U.S. Senate,,DEM,"Jack Daniel Foster, Jr.",1,2,0,0,0,3,2,1
Atascosa,11,U.S. Senate,,DEM,"Jack Daniel Foster, Jr.",1,0,0,0,0,1,0,1
Atascosa,12,U.S. Senate,,DEM,"Jack Daniel Foster, Jr.",2,0,0,0,0,2,0,2
Atascosa,13,U.S. Senate,,DEM,"Jack Daniel Foster, Jr.",2,3,1,0,0,6,4,2
Atascosa,14,U.S. Senate,,DEM,"Jack Daniel Foster, Jr.",0,0,0,0,0,0,0,0
Atascosa,15,U.S. Senate,,DEM,"Jack Daniel Foster, Jr.",3,0,2,0,0,5,2,3
Atascosa,16,U.S. Senate,,DEM,"Jack Daniel Foster, Jr.",1,0,0,0,0,1,0,1
Atascosa,17,U.S. Senate,,DEM,"Jack Daniel Foster, Jr.",0,2,1,0,0,3,3,0
Atascosa,18,U.S. Senate,,DEM,"Jack Daniel Foster, Jr.",5,5,0,0,0,10,5,5
Atascosa,19,U.S. Senate,,DEM,"Jack Daniel Foster, Jr.",0,1,0,0,0,1,1,0
Atascosa,20,U.S. Senate,,DEM,"Jack Daniel Foster, Jr.",2,1,1,0,0,4,2,2
Atascosa,21,U.S. Senate,,DEM,"Jack Daniel Foster, Jr.",0,0,0,0,0,0,0,0
Atascosa,22,U.S. Senate,,DEM,"Jack Daniel Foster, Jr.",0,2,0,0,0,2,2,0
Atascosa,23,U.S. Senate,,DEM,"Jack Daniel Foster, Jr.",0,0,1,0,0,1,1,0
Atascosa,24,U.S. Senate,,DEM,"Jack Daniel Foster, Jr.",1,1,0,0,0,2,1,1
Atascosa,1,U.S. Senate,,DEM,Sema Hernandez,5,1,2,0,0,8,3,5
Atascosa,2,U.S. Senate,,DEM,Sema Hernandez,8,1,1,0,0,10,2,8
Atascosa,3,U.S. Senate,,DEM,Sema Hernandez,4,2,2,0,0,8,4,4
Atascosa,4,U.S. Senate,,DEM,Sema Hernandez,0,0,1,0,0,1,1,0
Atascosa,5,U.S. Senate,,DEM,Sema Hernandez,10,5,0,0,0,15,5,10
Atascosa,6,U.S. Senate,,DEM,Sema Hernandez,1,0,0,0,0,1,0,1
Atascosa,7,U.S. Senate,,DEM,Sema Hernandez,10,4,3,0,0,17,7,10
Atascosa,8,U.S. Senate,,DEM,Sema Hernandez,1,5,0,0,0,6,5,1
Atascosa,9,U.S. Senate,,DEM,Sema Hernandez,0,0,0,0,0,0,0,0
Atascosa,10,U.S. Senate,,DEM,Sema Hernandez,12,0,0,0,0,12,0,12
Atascosa,11,U.S. Senate,,DEM,Sema Hernandez,0,0,0,0,0,0,0,0
Atascosa,12,U.S. Senate,,DEM,Sema Hernandez,8,1,1,0,0,10,2,8
Atascosa,13,U.S. Senate,,DEM,Sema Hernandez,10,15,4,1,0,30,19,11
Atascosa,14,U.S. Senate,,DEM,Sema Hernandez,4,2,0,0,0,6,2,4
Atascosa,15,U.S. Senate,,DEM,Sema Hernandez,23,1,2,0,0,26,3,23
Atascosa,16,U.S. Senate,,DEM,Sema Hernandez,1,1,0,0,0,2,1,1
Atascosa,17,U.S. Senate,,DEM,Sema Hernandez,18,13,5,0,0,36,18,18
Atascosa,18,U.S. Senate,,DEM,Sema Hernandez,25,6,1,0,0,32,7,25
Atascosa,19,U.S. Senate,,DEM,Sema Hernandez,3,0,2,0,0,5,2,3
Atascosa,20,U.S. Senate,,DEM,Sema Hernandez,10,9,0,0,0,19,9,10
Atascosa,21,U.S. Senate,,DEM,Sema Hernandez,0,0,0,0,0,0,0,0
Atascosa,22,U.S. Senate,,DEM,Sema Hernandez,0,0,0,0,0,0,0,0
Atascosa,23,U.S. Senate,,DEM,Sema Hernandez,6,2,0,0,0,8,2,6
Atascosa,24,U.S. Senate,,DEM,Sema Hernandez,7,2,0,0,0,9,2,7
Atascosa,1,U.S. Senate,,DEM,Cristina Tzintzun Ramirez,9,5,0,0,0,14,5,9
Atascosa,2,U.S. Senate,,DEM,Cristina Tzintzun Ramirez,12,4,1,0,0,17,5,12
Atascosa,3,U.S. Senate,,DEM,Cristina Tzintzun Ramirez,21,8,5,0,0,34,13,21
Atascosa,4,U.S. Senate,,DEM,Cristina Tzintzun Ramirez,5,0,0,0,0,5,0,5
Atascosa,5,U.S. Senate,,DEM,Cristina Tzintzun Ramirez,25,8,3,0,0,36,11,25
Atascosa,6,U.S. Senate,,DEM,Cristina Tzintzun Ramirez,0,0,0,0,0,0,0,0
Atascosa,7,U.S. Senate,,DEM,Cristina Tzintzun Ramirez,21,5,3,0,0,29,8,21
Atascosa,8,U.S. Senate,,DEM,Cristina Tzintzun Ramirez,8,4,1,0,0,13,5,8
Atascosa,9,U.S. Senate,,DEM,Cristina Tzintzun Ramirez,0,0,0,0,0,0,0,0
Atascosa,10,U.S. Senate,,DEM,Cristina Tzintzun Ramirez,22,9,1,0,0,32,10,22
Atascosa,11,U.S. Senate,,DEM,Cristina Tzintzun Ramirez,1,0,2,0,0,3,2,1
Atascosa,12,U.S. Senate,,DEM,Cristina Tzintzun Ramirez,11,4,2,0,0,17,6,11
Atascosa,13,U.S. Senate,,DEM,Cristina Tzintzun Ramirez,25,31,5,0,0,61,36,25
Atascosa,14,U.S. Senate,,DEM,Cristina Tzintzun Ramirez,8,3,1,0,0,12,4,8
Atascosa,15,U.S. Senate,,DEM,Cristina Tzintzun Ramirez,42,8,7,0,0,57,15,42
Atascosa,16,U.S. Senate,,DEM,Cristina Tzintzun Ramirez,5,3,0,0,0,8,3,5
Atascosa,17,U.S. Senate,,DEM,Cristina Tzintzun Ramirez,57,28,7,0,0,92,35,57
Atascosa,18,U.S. Senate,,DEM,Cristina Tzintzun Ramirez,40,8,5,0,0,53,13,40
Atascosa,19,U.S. Senate,,DEM,Cristina Tzintzun Ramirez,3,7,2,0,0,12,9,3
Atascosa,20,U.S. Senate,,DEM,Cristina Tzintzun Ramirez,31,23,3,0,0,57,26,31
Atascosa,21,U.S. Senate,,DEM,Cristina Tzintzun Ramirez,1,1,0,0,0,2,1,1
Atascosa,22,U.S. Senate,,DEM,Cristina Tzintzun Ramirez,8,5,3,0,0,16,8,8
Atascosa,23,U.S. Senate,,DEM,Cristina Tzintzun Ramirez,19,3,2,0,0,24,5,19
Atascosa,24,U.S. Senate,,DEM,Cristina Tzintzun Ramirez,29,15,1,0,0,45,16,29
Atascosa,1,U.S. Senate,,DEM,Michael Cooper,1,0,0,0,0,1,0,1
Atascosa,2,U.S. Senate,,DEM,Michael Cooper,1,1,1,0,0,3,2,1
Atascosa,3,U.S. Senate,,DEM,Michael Cooper,2,0,1,0,0,3,1,2
Atascosa,4,U.S. Senate,,DEM,Michael Cooper,0,0,0,0,0,0,0,0
Atascosa,5,U.S. Senate,,DEM,Michael Cooper,3,0,1,0,0,4,1,3
Atascosa,6,U.S. Senate,,DEM,Michael Cooper,0,1,0,0,0,1,1,0
Atascosa,7,U.S. Senate,,DEM,Michael Cooper,1,0,0,0,0,1,0,1
Atascosa,8,U.S. Senate,,DEM,Michael Cooper,0,1,0,0,0,1,1,0
Atascosa,9,U.S. Senate,,DEM,Michael Cooper,1,0,0,0,0,1,0,1
Atascosa,10,U.S. Senate,,DEM,Michael Cooper,3,2,0,0,0,5,2,3
Atascosa,11,U.S. Senate,,DEM,Michael Cooper,0,0,0,0,0,0,0,0
Atascosa,12,U.S. Senate,,DEM,Michael Cooper,1,1,0,0,0,2,1,1
Atascosa,13,U.S. Senate,,DEM,Michael Cooper,3,3,1,0,0,7,4,3
Atascosa,14,U.S. Senate,,DEM,Michael Cooper,0,2,2,0,0,4,4,0
Atascosa,15,U.S. Senate,,DEM,Michael Cooper,3,2,0,0,0,5,2,3
Atascosa,16,U.S. Senate,,DEM,Michael Cooper,1,0,0,0,0,1,0,1
Atascosa,17,U.S. Senate,,DEM,Michael Cooper,4,2,1,0,0,7,3,4
Atascosa,18,U.S. Senate,,DEM,Michael Cooper,6,3,0,0,0,9,3,6
Atascosa,19,U.S. Senate,,DEM,Michael Cooper,1,2,0,0,0,3,2,1
Atascosa,20,U.S. Senate,,DEM,Michael Cooper,12,4,0,0,0,16,4,12
Atascosa,21,U.S. Senate,,DEM,Michael Cooper,0,0,0,0,0,0,0,0
Atascosa,22,U.S. Senate,,DEM,Michael Cooper,0,1,0,0,0,1,1,0
Atascosa,23,U.S. Senate,,DEM,Michael Cooper,0,0,0,0,0,0,0,0
Atascosa,24,U.S. Senate,,DEM,Michael Cooper,4,0,1,0,0,5,1,4
Atascosa,1,U.S. Senate,,DEM,Royce West,2,1,0,0,0,3,1,2
Atascosa,2,U.S. Senate,,DEM,Royce West,1,0,0,0,0,1,0,1
Atascosa,3,U.S. Senate,,DEM,Royce West,2,5,0,0,0,7,5,2
Atascosa,4,U.S. Senate,,DEM,Royce West,0,0,0,0,0,0,0,0
Atascosa,5,U.S. Senate,,DEM,Royce West,2,1,0,0,0,3,1,2
Atascosa,6,U.S. Senate,,DEM,Royce West,1,0,0,0,0,1,0,1
Atascosa,7,U.S. Senate,,DEM,Royce West,1,2,1,0,0,4,3,1
Atascosa,8,U.S. Senate,,DEM,Royce West,0,0,0,0,0,0,0,0
Atascosa,9,U.S. Senate,,DEM,Royce West,0,0,0,0,0,0,0,0
Atascosa,10,U.S. Senate,,DEM,Royce West,1,1,0,0,0,2,1,1
Atascosa,11,U.S. Senate,,DEM,Royce West,0,0,0,0,0,0,0,0
Atascosa,12,U.S. Senate,,DEM,Royce West,2,0,0,0,0,2,0,2
Atascosa,13,U.S. Senate,,DEM,Royce West,8,6,3,0,0,17,9,8
Atascosa,14,U.S. Senate,,DEM,Royce West,1,1,0,0,0,2,1,1
Atascosa,15,U.S. Senate,,DEM,Royce West,0,1,1,0,0,2,2,0
Atascosa,16,U.S. Senate,,DEM,Royce West,0,0,0,0,0,0,0,0
Atascosa,17,U.S. Senate,,DEM,Royce West,7,5,1,0,0,13,6,7
Atascosa,18,U.S. Senate,,DEM,Royce West,7,1,0,0,0,8,1,7
Atascosa,19,U.S. Senate,,DEM,Royce West,1,3,0,0,0,4,3,1
Atascosa,20,U.S. Senate,,DEM,Royce West,7,4,1,0,0,12,5,7
Atascosa,21,U.S. Senate,,DEM,Royce West,0,0,0,0,0,0,0,0
Atascosa,22,U.S. Senate,,DEM,Royce West,0,0,0,0,0,0,0,0
Atascosa,23,U.S. Senate,,DEM,Royce West,1,0,0,0,0,1,0,1
Atascosa,24,U.S. Senate,,DEM,Royce West,1,1,0,0,0,2,1,1
Atascosa,1,U.S. Senate,,DEM,"Annie ""Mama"" Garcia",4,3,3,0,0,10,6,4
Atascosa,2,U.S. Senate,,DEM,"Annie ""Mama"" Garcia",7,2,0,0,0,9,2,7
Atascosa,3,U.S. Senate,,DEM,"Annie ""Mama"" Garcia",13,9,1,0,0,23,10,13
Atascosa,4,U.S. Senate,,DEM,"Annie ""Mama"" Garcia",1,1,0,0,0,2,1,1
Atascosa,5,U.S. Senate,,DEM,"Annie ""Mama"" Garcia",12,8,6,0,0,26,14,12
Atascosa,6,U.S. Senate,,DEM,"Annie ""Mama"" Garcia",0,0,0,0,0,0,0,0
Atascosa,7,U.S. Senate,,DEM,"Annie ""Mama"" Garcia",4,4,1,0,0,9,5,4
Atascosa,8,U.S. Senate,,DEM,"Annie ""Mama"" Garcia",2,3,0,0,0,5,3,2
Atascosa,9,U.S. Senate,,DEM,"Annie ""Mama"" Garcia",1,0,0,0,0,1,0,1
Atascosa,10,U.S. Senate,,DEM,"Annie ""Mama"" Garcia",10,5,1,0,0,16,6,10
Atascosa,11,U.S. Senate,,DEM,"Annie ""Mama"" Garcia",0,0,0,0,0,0,0,0
Atascosa,12,U.S. Senate,,DEM,"Annie ""Mama"" Garcia",7,6,4,1,0,18,10,8
Atascosa,13,U.S. Senate,,DEM,"Annie ""Mama"" Garcia",16,15,6,0,0,37,21,16
Atascosa,14,U.S. Senate,,DEM,"Annie ""Mama"" Garcia",6,3,0,0,0,9,3,6
Atascosa,15,U.S. Senate,,DEM,"Annie ""Mama"" Garcia",22,4,3,0,0,29,7,22
Atascosa,16,U.S. Senate,,DEM,"Annie ""Mama"" Garcia",1,0,0,0,0,1,0,1
Atascosa,17,U.S. Senate,,DEM,"Annie ""Mama"" Garcia",35,22,3,0,0,60,25,35
Atascosa,18,U.S. Senate,,DEM,"Annie ""Mama"" Garcia",31,9,3,0,0,43,12,31
Atascosa,19,U.S. Senate,,DEM,"Annie ""Mama"" Garcia",2,2,0,0,0,4,2,2
Atascosa,20,U.S. Senate,,DEM,"Annie ""Mama"" Garcia",13,13,2,1,0,29,15,14
Atascosa,21,U.S. Senate,,DEM,"Annie ""Mama"" Garcia",1,0,0,0,0,1,0,1
Atascosa,22,U.S. Senate,,DEM,"Annie ""Mama"" Garcia",8,0,0,0,0,8,0,8
Atascosa,23,U.S. Senate,,DEM,"Annie ""Mama"" Garcia",7,3,3,0,0,13,6,7
Atascosa,24,U.S. Senate,,DEM,"Annie ""Mama"" Garcia",11,6,1,0,0,18,7,11
Atascosa,1,U.S. Senate,,DEM,Over Votes,0,0,0,0,0,0,0,0
Atascosa,2,U.S. Senate,,DEM,Over Votes,0,0,0,0,0,0,0,0
Atascosa,3,U.S. Senate,,DEM,Over Votes,0,0,0,0,0,0,0,0
Atascosa,4,U.S. Senate,,DEM,Over Votes,0,0,0,0,0,0,0,0
Atascosa,5,U.S. Senate,,DEM,Over Votes,0,0,0,0,0,0,0,0
Atascosa,6,U.S. Senate,,DEM,Over Votes,0,0,0,0,0,0,0,0
Atascosa,7,U.S. Senate,,DEM,Over Votes,0,0,0,0,0,0,0,0
Atascosa,8,U.S. Senate,,DEM,Over Votes,0,0,0,0,0,0,0,0
Atascosa,9,U.S. Senate,,DEM,Over Votes,0,0,0,0,0,0,0,0
Atascosa,10,U.S. Senate,,DEM,Over Votes,0,0,0,0,0,0,0,0
Atascosa,11,U.S. Senate,,DEM,Over Votes,0,0,0,0,0,0,0,0
Atascosa,12,U.S. Senate,,DEM,Over Votes,0,0,0,0,0,0,0,0
Atascosa,13,U.S. Senate,,DEM,Over Votes,0,0,0,0,0,0,0,0
Atascosa,14,U.S. Senate,,DEM,Over Votes,0,0,0,0,0,0,0,0
Atascosa,15,U.S. Senate,,DEM,Over Votes,0,0,0,0,0,0,0,0
Atascosa,16,U.S. Senate,,DEM,Over Votes,0,0,0,0,0,0,0,0
Atascosa,17,U.S. Senate,,DEM,Over Votes,0,0,0,0,0,0,0,0
Atascosa,18,U.S. Senate,,DEM,Over Votes,0,0,0,0,0,0,0,0
Atascosa,19,U.S. Senate,,DEM,Over Votes,0,0,0,0,0,0,0,0
Atascosa,20,U.S. Senate,,DEM,Over Votes,0,0,0,0,0,0,0,0
Atascosa,21,U.S. Senate,,DEM,Over Votes,0,0,0,0,0,0,0,0
Atascosa,22,U.S. Senate,,DEM,Over Votes,0,0,0,0,0,0,0,0
Atascosa,23,U.S. Senate,,DEM,Over Votes,0,0,0,0,0,0,0,0
Atascosa,24,U.S. Senate,,DEM,Over Votes,0,0,0,0,0,0,0,0
Atascosa,1,U.S. Senate,,DEM,Under Votes,1,0,0,0,0,1,0,1
Atascosa,2,U.S. Senate,,DEM,Under Votes,2,1,2,0,0,5,3,2
Atascosa,3,U.S. Senate,,DEM,Under Votes,8,4,4,0,0,16,8,8
Atascosa,4,U.S. Senate,,DEM,Under Votes,4,0,1,0,0,5,1,4
Atascosa,5,U.S. Senate,,DEM,Under Votes,6,3,3,0,0,12,6,6
Atascosa,6,U.S. Senate,,DEM,Under Votes,0,0,2,0,0,2,2,0
Atascosa,7,U.S. Senate,,DEM,Under Votes,12,0,3,0,0,15,3,12
Atascosa,8,U.S. Senate,,DEM,Under Votes,8,4,0,0,0,12,4,8
Atascosa,9,U.S. Senate,,DEM,Under Votes,0,0,0,0,0,0,0,0
Atascosa,10,U.S. Senate,,DEM,Under Votes,9,6,1,0,0,16,7,9
Atascosa,11,U.S. Senate,,DEM,Under Votes,0,0,0,0,0,0,0,0
Atascosa,12,U.S. Senate,,DEM,Under Votes,2,6,4,0,0,12,10,2
Atascosa,13,U.S. Senate,,DEM,Under Votes,6,11,1,0,0,18,12,6
Atascosa,14,U.S. Senate,,DEM,Under Votes,7,5,2,0,0,14,7,7
Atascosa,15,U.S. Senate,,DEM,Under Votes,7,7,8,0,1,23,15,7
Atascosa,16,U.S. Senate,,DEM,Under Votes,3,5,2,0,0,10,7,3
Atascosa,17,U.S. Senate,,DEM,Under Votes,37,27,6,1,0,71,33,38
Atascosa,18,U.S. Senate,,DEM,Under Votes,54,14,5,0,0,73,19,54
Atascosa,19,U.S. Senate,,DEM,Under Votes,0,7,1,0,0,8,8,0
Atascosa,20,U.S. Senate,,DEM,Under Votes,12,16,2,0,0,30,18,12
Atascosa,21,U.S. Senate,,DEM,Under Votes,4,0,0,0,0,4,0,4
Atascosa,22,U.S. Senate,,DEM,Under Votes,0,0,2,0,0,2,2,0
Atascosa,23,U.S. Senate,,DEM,Under Votes,1,1,0,0,0,2,1,1
Atascosa,24,U.S. Senate,,DEM,Under Votes,7,2,3,1,0,13,5,8
Atascosa,1,U.S. House,28,DEM,Jessica Cisneros,11,10,0,0,0,21,10,11
Atascosa,2,U.S. House,28,DEM,Jessica Cisneros,31,5,6,0,0,42,11,31
Atascosa,3,U.S. House,28,DEM,Jessica Cisneros,38,20,0,0,0,58,20,38
Atascosa,4,U.S. House,28,DEM,Jessica Cisneros,6,0,0,0,0,6,0,6
Atascosa,5,U.S. House,28,DEM,Jessica Cisneros,53,23,7,2,0,85,30,55
Atascosa,6,U.S. House,28,DEM,Jessica Cisneros,1,0,0,0,0,1,0,1
Atascosa,7,U.S. House,28,DEM,Jessica Cisneros,41,11,6,1,0,59,17,42
Atascosa,8,U.S. House,28,DEM,Jessica Cisneros,9,13,0,0,0,22,13,9
Atascosa,9,U.S. House,28,DEM,Jessica Cisneros,2,0,0,0,0,2,0,2
Atascosa,10,U.S. House,28,DEM,Jessica Cisneros,35,17,2,0,0,54,19,35
Atascosa,11,U.S. House,28,DEM,Jessica Cisneros,3,0,0,0,0,3,0,3
Atascosa,12,U.S. House,28,DEM,Jessica Cisneros,37,16,7,1,0,61,23,38
Atascosa,13,U.S. House,28,DEM,Jessica Cisneros,48,38,2,0,0,88,40,48
Atascosa,14,U.S. House,28,DEM,Jessica Cisneros,14,8,2,0,0,24,10,14
Atascosa,15,U.S. House,28,DEM,Jessica Cisneros,62,14,9,0,1,86,23,62
Atascosa,16,U.S. House,28,DEM,Jessica Cisneros,8,3,3,0,0,14,6,8
Atascosa,17,U.S. House,28,DEM,Jessica Cisneros,80,42,6,2,0,130,48,82
Atascosa,18,U.S. House,28,DEM,Jessica Cisneros,61,19,6,0,0,86,25,61
Atascosa,19,U.S. House,28,DEM,Jessica Cisneros,8,9,3,0,0,20,12,8
Atascosa,20,U.S. House,28,DEM,Jessica Cisneros,60,50,7,0,0,117,57,60
Atascosa,21,U.S. House,28,DEM,Jessica Cisneros,6,1,0,0,0,7,1,6
Atascosa,22,U.S. House,28,DEM,Jessica Cisneros,13,5,0,0,0,18,5,13
Atascosa,23,U.S. House,28,DEM,Jessica Cisneros,28,10,4,0,0,42,14,28
Atascosa,24,U.S. House,28,DEM,Jessica Cisneros,74,40,7,1,0,122,47,75
Atascosa,1,U.S. House,28,DEM,Henry Cuellar,18,12,6,0,0,36,18,18
Atascosa,2,U.S. House,28,DEM,Henry Cuellar,18,10,8,0,0,36,18,18
Atascosa,3,U.S. House,28,DEM,Henry Cuellar,42,30,21,1,0,94,51,43
Atascosa,4,U.S. House,28,DEM,Henry Cuellar,6,1,2,0,0,9,3,6
Atascosa,5,U.S. House,28,DEM,Henry Cuellar,31,26,12,0,0,69,38,31
Atascosa,6,U.S. House,28,DEM,Henry Cuellar,1,2,2,0,0,5,4,1
Atascosa,7,U.S. House,28,DEM,Henry Cuellar,42,16,6,0,0,64,22,42
Atascosa,8,U.S. House,28,DEM,Henry Cuellar,26,13,1,0,0,40,14,26
Atascosa,9,U.S. House,28,DEM,Henry Cuellar,4,0,2,0,0,6,2,4
Atascosa,10,U.S. House,28,DEM,Henry Cuellar,46,20,4,0,0,70,24,46
Atascosa,11,U.S. House,28,DEM,Henry Cuellar,0,0,3,0,0,3,3,0
Atascosa,12,U.S. House,28,DEM,Henry Cuellar,22,10,9,0,0,41,19,22
Atascosa,13,U.S. House,28,DEM,Henry Cuellar,55,72,35,1,0,163,107,56
Atascosa,14,U.S. House,28,DEM,Henry Cuellar,17,14,5,0,0,36,19,17
Atascosa,15,U.S. House,28,DEM,Henry Cuellar,65,32,31,0,0,128,63,65
Atascosa,16,U.S. House,28,DEM,Henry Cuellar,4,9,0,0,0,13,9,4
Atascosa,17,U.S. House,28,DEM,Henry Cuellar,140,94,22,0,0,256,116,140
Atascosa,18,U.S. House,28,DEM,Henry Cuellar,134,41,20,0,0,195,61,134
Atascosa,19,U.S. House,28,DEM,Henry Cuellar,8,19,3,0,0,30,22,8
Atascosa,20,U.S. House,28,DEM,Henry Cuellar,88,69,18,1,0,176,87,89
Atascosa,21,U.S. House,28,DEM,Henry Cuellar,4,3,0,0,0,7,3,4
Atascosa,22,U.S. House,28,DEM,Henry Cuellar,15,12,5,0,0,32,17,15
Atascosa,23,U.S. House,28,DEM,Henry Cuellar,16,8,5,0,0,29,13,16
Atascosa,24,U.S. House,28,DEM,Henry Cuellar,21,17,6,0,0,44,23,21
Atascosa,1,U.S. House,28,DEM,Over Votes,0,0,0,0,0,0,0,0
Atascosa,2,U.S. House,28,DEM,Over Votes,0,0,0,0,0,0,0,0
Atascosa,3,U.S. House,28,DEM,Over Votes,0,0,0,0,0,0,0,0
Atascosa,4,U.S. House,28,DEM,Over Votes,0,0,0,0,0,0,0,0
Atascosa,5,U.S. House,28,DEM,Over Votes,0,0,0,0,0,0,0,0
Atascosa,6,U.S. House,28,DEM,Over Votes,0,0,0,0,0,0,0,0
Atascosa,7,U.S. House,28,DEM,Over Votes,0,0,0,0,0,0,0,0
Atascosa,8,U.S. House,28,DEM,Over Votes,0,0,0,0,0,0,0,0
Atascosa,9,U.S. House,28,DEM,Over Votes,0,0,0,0,0,0,0,0
Atascosa,10,U.S. House,28,DEM,Over Votes,0,0,0,0,0,0,0,0
Atascosa,11,U.S. House,28,DEM,Over Votes,0,0,0,0,0,0,0,0
Atascosa,12,U.S. House,28,DEM,Over Votes,0,0,0,0,0,0,0,0
Atascosa,13,U.S. House,28,DEM,Over Votes,0,0,0,0,0,0,0,0
Atascosa,14,U.S. House,28,DEM,Over Votes,0,0,0,0,0,0,0,0
Atascosa,15,U.S. House,28,DEM,Over Votes,0,0,0,0,0,0,0,0
Atascosa,16,U.S. House,28,DEM,Over Votes,0,0,0,0,0,0,0,0
Atascosa,17,U.S. House,28,DEM,Over Votes,0,0,0,0,0,0,0,0
Atascosa,18,U.S. House,28,DEM,Over Votes,0,0,0,0,0,0,0,0
Atascosa,19,U.S. House,28,DEM,Over Votes,0,0,0,0,0,0,0,0
Atascosa,20,U.S. House,28,DEM,Over Votes,0,0,0,0,0,0,0,0
Atascosa,21,U.S. House,28,DEM,Over Votes,0,0,0,0,0,0,0,0
Atascosa,22,U.S. House,28,DEM,Over Votes,0,0,0,0,0,0,0,0
Atascosa,23,U.S. House,28,DEM,Over Votes,0,0,0,0,0,0,0,0
Atascosa,24,U.S. House,28,DEM,Over Votes,0,0,0,0,0,0,0,0
Atascosa,1,U.S. House,28,DEM,Under Votes,0,0,0,0,0,0,0,0
Atascosa,2,U.S. House,28,DEM,Under Votes,1,0,0,0,0,1,0,1
Atascosa,3,U.S. House,28,DEM,Under Votes,1,1,0,0,0,2,1,1
Atascosa,4,U.S. House,28,DEM,Under Votes,2,0,0,0,0,2,0,2
Atascosa,5,U.S. House,28,DEM,Under Votes,1,0,0,0,0,1,0,1
Atascosa,6,U.S. House,28,DEM,Under Votes,0,0,0,0,0,0,0,0
Atascosa,7,U.S. House,28,DEM,Under Votes,2,0,1,0,0,3,1,2
Atascosa,8,U.S. House,28,DEM,Under Votes,1,0,0,0,0,1,0,1
Atascosa,9,U.S. House,28,DEM,Under Votes,0,0,0,0,0,0,0,0
Atascosa,10,U.S. House,28,DEM,Under Votes,6,1,0,0,0,7,1,6
Atascosa,11,U.S. House,28,DEM,Under Votes,0,0,0,0,0,0,0,0
Atascosa,12,U.S. House,28,DEM,Under Votes,0,3,0,0,0,3,3,0
Atascosa,13,U.S. House,28,DEM,Under Votes,2,2,0,0,0,4,2,2
Atascosa,14,U.S. House,28,DEM,Under Votes,5,0,0,0,0,5,0,5
Atascosa,15,U.S. House,28,DEM,Under Votes,3,1,1,0,0,5,2,3
Atascosa,16,U.S. House,28,DEM,Under Votes,2,0,0,0,0,2,0,2
Atascosa,17,U.S. House,28,DEM,Under Votes,10,4,0,0,0,14,4,10
Atascosa,18,U.S. House,28,DEM,Under Votes,22,5,0,0,0,27,5,22
Atascosa,19,U.S. House,28,DEM,Under Votes,1,2,0,0,0,3,2,1
Atascosa,20,U.S. House,28,DEM,Under Votes,2,7,0,0,0,9,7,2
Atascosa,21,U.S. House,28,DEM,Under Votes,2,1,0,0,0,3,1,2
Atascosa,22,U.S. House,28,DEM,Under Votes,0,0,0,0,0,0,0,0
Atascosa,23,U.S. House,28,DEM,Under Votes,0,0,0,0,0,0,0,0
Atascosa,24,U.S. House,28,DEM,Under Votes,5,0,0,0,0,5,0,5
Atascosa,1,Railroad Commissioner,,DEM,"Roberto R. ""Beto"" Alonzo",13,12,5,0,0,30,17,13
Atascosa,2,Railroad Commissioner,,DEM,"Roberto R. ""Beto"" Alonzo",21,4,5,0,0,30,9,21
Atascosa,3,Railroad Commissioner,,DEM,"Roberto R. ""Beto"" Alonzo",39,18,7,0,0,64,25,39
Atascosa,4,Railroad Commissioner,,DEM,"Roberto R. ""Beto"" Alonzo",7,1,1,0,0,9,2,7
Atascosa,5,Railroad Commissioner,,DEM,"Roberto R. ""Beto"" Alonzo",51,22,10,0,0,83,32,51
Atascosa,6,Railroad Commissioner,,DEM,"Roberto R. ""Beto"" Alonzo",1,1,0,0,0,2,1,1
Atascosa,7,Railroad Commissioner,,DEM,"Roberto R. ""Beto"" Alonzo",38,13,2,0,0,53,15,38
Atascosa,8,Railroad Commissioner,,DEM,"Roberto R. ""Beto"" Alonzo",19,12,0,0,0,31,12,19
Atascosa,9,Railroad Commissioner,,DEM,"Roberto R. ""Beto"" Alonzo",3,0,0,0,0,3,0,3
Atascosa,10,Railroad Commissioner,,DEM,"Roberto R. ""Beto"" Alonzo",47,21,2,0,0,70,23,47
Atascosa,11,Railroad Commissioner,,DEM,"Roberto R. ""Beto"" Alonzo",0,0,2,0,0,2,2,0
Atascosa,12,Railroad Commissioner,,DEM,"Roberto R. ""Beto"" Alonzo",26,5,7,1,0,39,12,27
Atascosa,13,Railroad Commissioner,,DEM,"Roberto R. ""Beto"" Alonzo",56,50,16,1,0,123,66,57
Atascosa,14,Railroad Commissioner,,DEM,"Roberto R. ""Beto"" Alonzo",16,9,3,0,0,28,12,16
Atascosa,15,Railroad Commissioner,,DEM,"Roberto R. ""Beto"" Alonzo",66,19,23,0,0,108,42,66
Atascosa,16,Railroad Commissioner,,DEM,"Roberto R. ""Beto"" Alonzo",6,7,0,0,0,13,7,6
Atascosa,17,Railroad Commissioner,,DEM,"Roberto R. ""Beto"" Alonzo",117,72,12,2,0,203,84,119
Atascosa,18,Railroad Commissioner,,DEM,"Roberto R. ""Beto"" Alonzo",98,24,13,0,0,135,37,98
Atascosa,19,Railroad Commissioner,,DEM,"Roberto R. ""Beto"" Alonzo",8,10,2,0,0,20,12,8
Atascosa,20,Railroad Commissioner,,DEM,"Roberto R. ""Beto"" Alonzo",72,33,10,0,0,115,43,72
Atascosa,21,Railroad Commissioner,,DEM,"Roberto R. ""Beto"" Alonzo",5,0,0,0,0,5,0,5
Atascosa,22,Railroad Commissioner,,DEM,"Roberto R. ""Beto"" Alonzo",18,10,0,0,0,28,10,18
Atascosa,23,Railroad Commissioner,,DEM,"Roberto R. ""Beto"" Alonzo",22,5,2,0,0,29,7,22
Atascosa,24,Railroad Commissioner,,DEM,"Roberto R. ""Beto"" Alonzo",42,21,6,0,0,69,27,42
Atascosa,1,Railroad Commissioner,,DEM,Mark Watson,4,4,0,0,0,8,4,4
Atascosa,2,Railroad Commissioner,,DEM,Mark Watson,2,3,4,0,0,9,7,2
Atascosa,3,Railroad Commissioner,,DEM,Mark Watson,8,3,3,1,0,15,6,9
Atascosa,4,Railroad Commissioner,,DEM,Mark Watson,1,0,0,0,0,1,0,1
Atascosa,5,Railroad Commissioner,,DEM,Mark Watson,5,4,0,2,0,11,4,7
Atascosa,6,Railroad Commissioner,,DEM,Mark Watson,1,1,0,0,0,2,1,1
Atascosa,7,Railroad Commissioner,,DEM,Mark Watson,9,5,0,0,0,14,5,9
Atascosa,8,Railroad Commissioner,,DEM,Mark Watson,5,4,0,0,0,9,4,5
Atascosa,9,Railroad Commissioner,,DEM,Mark Watson,1,0,2,0,0,3,2,1
Atascosa,10,Railroad Commissioner,,DEM,Mark Watson,13,2,1,0,0,16,3,13
Atascosa,11,Railroad Commissioner,,DEM,Mark Watson,2,0,0,0,0,2,0,2
Atascosa,12,Railroad Commissioner,,DEM,Mark Watson,1,5,0,0,0,6,5,1
Atascosa,13,Railroad Commissioner,,DEM,Mark Watson,14,14,7,0,0,35,21,14
Atascosa,14,Railroad Commissioner,,DEM,Mark Watson,2,6,3,0,0,11,9,2
Atascosa,15,Railroad Commissioner,,DEM,Mark Watson,7,6,7,0,0,20,13,7
Atascosa,16,Railroad Commissioner,,DEM,Mark Watson,1,0,0,0,0,1,0,1
Atascosa,17,Railroad Commissioner,,DEM,Mark Watson,16,12,4,0,0,32,16,16
Atascosa,18,Railroad Commissioner,,DEM,Mark Watson,27,6,4,0,0,37,10,27
Atascosa,19,Railroad Commissioner,,DEM,Mark Watson,1,3,1,0,0,5,4,1
Atascosa,20,Railroad Commissioner,,DEM,Mark Watson,25,18,1,0,0,44,19,25
Atascosa,21,Railroad Commissioner,,DEM,Mark Watson,2,2,0,0,0,4,2,2
Atascosa,22,Railroad Commissioner,,DEM,Mark Watson,0,5,0,0,0,5,5,0
Atascosa,23,Railroad Commissioner,,DEM,Mark Watson,5,3,2,0,0,10,5,5
Atascosa,24,Railroad Commissioner,,DEM,Mark Watson,9,4,1,0,0,14,5,9
Atascosa,1,Railroad Commissioner,,DEM,Kelly Stone,2,2,0,0,0,4,2,2
Atascosa,2,Railroad Commissioner,,DEM,Kelly Stone,12,1,1,0,0,14,2,12
Atascosa,3,Railroad Commissioner,,DEM,Kelly Stone,9,6,2,0,0,17,8,9
Atascosa,4,Railroad Commissioner,,DEM,Kelly Stone,1,0,0,0,0,1,0,1
Atascosa,5,Railroad Commissioner,,DEM,Kelly Stone,5,4,0,0,0,9,4,5
Atascosa,6,Railroad Commissioner,,DEM,Kelly Stone,0,0,0,0,0,0,0,0
Atascosa,7,Railroad Commissioner,,DEM,Kelly Stone,11,4,3,0,0,18,7,11
Atascosa,8,Railroad Commissioner,,DEM,Kelly Stone,3,1,0,0,0,4,1,3
Atascosa,9,Railroad Commissioner,,DEM,Kelly Stone,2,0,0,0,0,2,0,2
Atascosa,10,Railroad Commissioner,,DEM,Kelly Stone,4,10,0,0,0,14,10,4
Atascosa,11,Railroad Commissioner,,DEM,Kelly Stone,1,0,1,0,0,2,1,1
Atascosa,12,Railroad Commissioner,,DEM,Kelly Stone,11,6,1,0,0,18,7,11
Atascosa,13,Railroad Commissioner,,DEM,Kelly Stone,7,7,4,0,0,18,11,7
Atascosa,14,Railroad Commissioner,,DEM,Kelly Stone,6,1,1,0,0,8,2,6
Atascosa,15,Railroad Commissioner,,DEM,Kelly Stone,10,2,0,0,0,12,2,10
Atascosa,16,Railroad Commissioner,,DEM,Kelly Stone,0,0,0,0,0,0,0,0
Atascosa,17,Railroad Commissioner,,DEM,Kelly Stone,12,13,1,0,0,26,14,12
Atascosa,18,Railroad Commissioner,,DEM,Kelly Stone,9,4,0,0,0,13,4,9
Atascosa,19,Railroad Commissioner,,DEM,Kelly Stone,2,5,1,0,0,8,6,2
Atascosa,20,Railroad Commissioner,,DEM,Kelly Stone,16,12,3,0,0,31,15,16
Atascosa,21,Railroad Commissioner,,DEM,Kelly Stone,0,2,0,0,0,2,2,0
Atascosa,22,Railroad Commissioner,,DEM,Kelly Stone,2,1,0,0,0,3,1,2
Atascosa,23,Railroad Commissioner,,DEM,Kelly Stone,3,2,2,0,0,7,4,3
Atascosa,24,Railroad Commissioner,,DEM,Kelly Stone,11,4,2,0,0,17,6,11
Atascosa,1,Railroad Commissioner,,DEM,Chrysta Castaneda,9,3,1,0,0,13,4,9
Atascosa,2,Railroad Commissioner,,DEM,Chrysta Castaneda,11,6,2,0,0,19,8,11
Atascosa,3,Railroad Commissioner,,DEM,Chrysta Castaneda,20,20,6,0,0,46,26,20
Atascosa,4,Railroad Commissioner,,DEM,Chrysta Castaneda,1,0,0,0,0,1,0,1
Atascosa,5,Railroad Commissioner,,DEM,Chrysta Castaneda,20,15,7,0,0,42,22,20
Atascosa,6,Railroad Commissioner,,DEM,Chrysta Castaneda,0,0,0,0,0,0,0,0
Atascosa,7,Railroad Commissioner,,DEM,Chrysta Castaneda,20,5,4,1,0,30,9,21
Atascosa,8,Railroad Commissioner,,DEM,Chrysta Castaneda,3,7,1,0,0,11,8,3
Atascosa,9,Railroad Commissioner,,DEM,Chrysta Castaneda,0,0,0,0,0,0,0,0
Atascosa,10,Railroad Commissioner,,DEM,Chrysta Castaneda,17,4,1,0,0,22,5,17
Atascosa,11,Railroad Commissioner,,DEM,Chrysta Castaneda,0,0,0,0,0,0,0,0
Atascosa,12,Railroad Commissioner,,DEM,Chrysta Castaneda,20,6,8,0,0,34,14,20
Atascosa,13,Railroad Commissioner,,DEM,Chrysta Castaneda,23,33,9,0,0,65,42,23
Atascosa,14,Railroad Commissioner,,DEM,Chrysta Castaneda,6,3,0,0,0,9,3,6
Atascosa,15,Railroad Commissioner,,DEM,Chrysta Castaneda,40,14,8,0,0,62,22,40
Atascosa,16,Railroad Commissioner,,DEM,Chrysta Castaneda,4,2,1,0,0,7,3,4
Atascosa,17,Railroad Commissioner,,DEM,Chrysta Castaneda,54,25,6,0,0,85,31,54
Atascosa,18,Railroad Commissioner,,DEM,Chrysta Castaneda,40,20,6,0,0,66,26,40
Atascosa,19,Railroad Commissioner,,DEM,Chrysta Castaneda,4,7,2,0,0,13,9,4
Atascosa,20,Railroad Commissioner,,DEM,Chrysta Castaneda,26,43,9,0,0,78,52,26
Atascosa,21,Railroad Commissioner,,DEM,Chrysta Castaneda,3,1,0,0,0,4,1,3
Atascosa,22,Railroad Commissioner,,DEM,Chrysta Castaneda,8,1,2,0,0,11,3,8
Atascosa,23,Railroad Commissioner,,DEM,Chrysta Castaneda,13,7,3,0,0,23,10,13
Atascosa,24,Railroad Commissioner,,DEM,Chrysta Castaneda,29,26,2,0,0,57,28,29
Atascosa,1,Railroad Commissioner,,DEM,Over Votes,0,0,0,0,0,0,0,0
Atascosa,2,Railroad Commissioner,,DEM,Over Votes,0,0,0,0,0,0,0,0
Atascosa,3,Railroad Commissioner,,DEM,Over Votes,0,0,2,0,0,2,2,0
Atascosa,4,Railroad Commissioner,,DEM,Over Votes,0,0,0,0,0,0,0,0
Atascosa,5,Railroad Commissioner,,DEM,Over Votes,0,0,0,0,0,0,0,0
Atascosa,6,Railroad Commissioner,,DEM,Over Votes,0,0,0,0,0,0,0,0
Atascosa,7,Railroad Commissioner,,DEM,Over Votes,0,0,0,0,0,0,0,0
Atascosa,8,Railroad Commissioner,,DEM,Over Votes,0,0,0,0,0,0,0,0
Atascosa,9,Railroad Commissioner,,DEM,Over Votes,0,0,0,0,0,0,0,0
Atascosa,10,Railroad Commissioner,,DEM,Over Votes,0,0,0,0,0,0,0,0
Atascosa,11,Railroad Commissioner,,DEM,Over Votes,0,0,0,0,0,0,0,0
Atascosa,12,Railroad Commissioner,,DEM,Over Votes,0,0,0,0,0,0,0,0
Atascosa,13,Railroad Commissioner,,DEM,Over Votes,0,0,1,0,0,1,1,0
Atascosa,14,Railroad Commissioner,,DEM,Over Votes,0,0,0,0,0,0,0,0
Atascosa,15,Railroad Commissioner,,DEM,Over Votes,0,0,0,0,0,0,0,0
Atascosa,16,Railroad Commissioner,,DEM,Over Votes,0,0,0,0,0,0,0,0
Atascosa,17,Railroad Commissioner,,DEM,Over Votes,0,0,0,0,0,0,0,0
Atascosa,18,Railroad Commissioner,,DEM,Over Votes,0,0,0,0,0,0,0,0
Atascosa,19,Railroad Commissioner,,DEM,Over Votes,0,0,0,0,0,0,0,0
Atascosa,20,Railroad Commissioner,,DEM,Over Votes,0,0,0,0,0,0,0,0
Atascosa,21,Railroad Commissioner,,DEM,Over Votes,0,0,0,0,0,0,0,0
Atascosa,22,Railroad Commissioner,,DEM,Over Votes,0,0,1,0,0,1,1,0
Atascosa,23,Railroad Commissioner,,DEM,Over Votes,0,0,0,0,0,0,0,0
Atascosa,24,Railroad Commissioner,,DEM,Over Votes,0,0,0,0,0,0,0,0
Atascosa,1,Railroad Commissioner,,DEM,Under Votes,1,1,0,0,0,2,1,1
Atascosa,2,Railroad Commissioner,,DEM,Under Votes,4,1,2,0,0,7,3,4
Atascosa,3,Railroad Commissioner,,DEM,Under Votes,5,4,1,0,0,10,5,5
Atascosa,4,Railroad Commissioner,,DEM,Under Votes,4,0,1,0,0,5,1,4
Atascosa,5,Railroad Commissioner,,DEM,Under Votes,4,4,2,0,0,10,6,4
Atascosa,6,Railroad Commissioner,,DEM,Under Votes,0,0,2,0,0,2,2,0
Atascosa,7,Railroad Commissioner,,DEM,Under Votes,7,0,4,0,0,11,4,7
Atascosa,8,Railroad Commissioner,,DEM,Under Votes,6,2,0,0,0,8,2,6
Atascosa,9,Railroad Commissioner,,DEM,Under Votes,0,0,0,0,0,0,0,0
Atascosa,10,Railroad Commissioner,,DEM,Under Votes,6,1,2,0,0,9,3,6
Atascosa,11,Railroad Commissioner,,DEM,Under Votes,0,0,0,0,0,0,0,0
Atascosa,12,Railroad Commissioner,,DEM,Under Votes,1,7,0,0,0,8,7,1
Atascosa,13,Railroad Commissioner,,DEM,Under Votes,5,8,0,0,0,13,8,5
Atascosa,14,Railroad Commissioner,,DEM,Under Votes,6,3,0,0,0,9,3,6
Atascosa,15,Railroad Commissioner,,DEM,Under Votes,7,6,3,0,1,17,9,7
Atascosa,16,Railroad Commissioner,,DEM,Under Votes,3,3,2,0,0,8,5,3
Atascosa,17,Railroad Commissioner,,DEM,Under Votes,31,18,5,0,0,54,23,31
Atascosa,18,Railroad Commissioner,,DEM,Under Votes,43,11,3,0,0,57,14,43
Atascosa,19,Railroad Commissioner,,DEM,Under Votes,2,5,0,0,0,7,5,2
Atascosa,20,Railroad Commissioner,,DEM,Under Votes,11,20,2,1,0,34,22,12
Atascosa,21,Railroad Commissioner,,DEM,Under Votes,2,0,0,0,0,2,0,2
Atascosa,22,Railroad Commissioner,,DEM,Under Votes,0,0,2,0,0,2,2,0
Atascosa,23,Railroad Commissioner,,DEM,Under Votes,1,1,0,0,0,2,1,1
Atascosa,24,Railroad Commissioner,,DEM,Under Votes,9,2,2,1,0,14,4,10
Atascosa,1,State Senate,19,DEM,Roland Gutierrez,9,13,6,0,0,28,19,9
Atascosa,2,State Senate,19,DEM,Roland Gutierrez,20,7,5,0,0,32,12,20
Atascosa,3,State Senate,19,DEM,Roland Gutierrez,34,29,12,0,0,75,41,34
Atascosa,4,State Senate,19,DEM,Roland Gutierrez,0,0,0,0,0,0,0,0
Atascosa,5,State Senate,19,DEM,Roland Gutierrez,35,18,7,0,0,60,25,35
Atascosa,6,State Senate,19,DEM,Roland Gutierrez,0,0,0,0,0,0,0,0
Atascosa,7,State Senate,19,DEM,Roland Gutierrez,39,10,8,0,0,57,18,39
Atascosa,8,State Senate,19,DEM,Roland Gutierrez,16,13,0,0,0,29,13,16
Atascosa,9,State Senate,19,DEM,Roland Gutierrez,0,0,0,0,0,0,0,0
Atascosa,10,State Senate,19,DEM,Roland Gutierrez,30,12,2,0,0,44,14,30
Atascosa,11,State Senate,19,DEM,Roland Gutierrez,0,0,0,0,0,0,0,0
Atascosa,12,State Senate,19,DEM,Roland Gutierrez,23,8,8,0,0,39,16,23
Atascosa,13,State Senate,19,DEM,Roland Gutierrez,46,50,21,0,0,117,71,46
Atascosa,14,State Senate,19,DEM,Roland Gutierrez,10,9,6,0,0,25,15,10
Atascosa,15,State Senate,19,DEM,Roland Gutierrez,55,27,33,0,0,115,60,55
Atascosa,16,State Senate,19,DEM,Roland Gutierrez,3,5,0,0,0,8,5,3
Atascosa,17,State Senate,19,DEM,Roland Gutierrez,120,83,18,2,0,223,101,122
Atascosa,18,State Senate,19,DEM,Roland Gutierrez,76,17,14,0,0,107,31,76
Atascosa,19,State Senate,19,DEM,Roland Gutierrez,5,12,4,0,0,21,16,5
Atascosa,20,State Senate,19,DEM,Roland Gutierrez,72,64,7,0,0,143,71,72
Atascosa,21,State Senate,19,DEM,Roland Gutierrez,0,0,0,0,0,0,0,0
Atascosa,22,State Senate,19,DEM,Roland Gutierrez,16,11,3,0,0,30,14,16
Atascosa,23,State Senate,19,DEM,Roland Gutierrez,21,5,5,0,0,31,10,21
Atascosa,24,State Senate,19,DEM,Roland Gutierrez,25,24,4,0,0,53,28,25
Atascosa,1,State Senate,19,DEM,Freddy Ramirez,5,1,0,0,0,6,1,5
Atascosa,2,State Senate,19,DEM,Freddy Ramirez,7,0,2,0,0,9,2,7
Atascosa,3,State Senate,19,DEM,Freddy Ramirez,13,8,3,0,0,24,11,13
Atascosa,4,State Senate,19,DEM,Freddy Ramirez,0,0,0,0,0,0,0,0
Atascosa,5,State Senate,19,DEM,Freddy Ramirez,16,6,1,2,0,25,7,18
Atascosa,6,State Senate,19,DEM,Freddy Ramirez,0,0,0,0,0,0,0,0
Atascosa,7,State Senate,19,DEM,Freddy Ramirez,5,4,0,0,0,9,4,5
Atascosa,8,State Senate,19,DEM,Freddy Ramirez,8,4,0,0,0,12,4,8
Atascosa,9,State Senate,19,DEM,Freddy Ramirez,0,0,0,0,0,0,0,0
Atascosa,10,State Senate,19,DEM,Freddy Ramirez,22,7,1,0,0,30,8,22
Atascosa,11,State Senate,19,DEM,Freddy Ramirez,0,0,0,0,0,0,0,0
Atascosa,12,State Senate,19,DEM,Freddy Ramirez,11,6,3,1,0,21,9,12
Atascosa,13,State Senate,19,DEM,Freddy Ramirez,22,19,8,0,0,49,27,22
Atascosa,14,State Senate,19,DEM,Freddy Ramirez,7,6,1,0,0,14,7,7
Atascosa,15,State Senate,19,DEM,Freddy Ramirez,15,5,1,0,0,21,6,15
Atascosa,16,State Senate,19,DEM,Freddy Ramirez,5,0,0,0,0,5,0,5
Atascosa,17,State Senate,19,DEM,Freddy Ramirez,23,24,6,0,0,53,30,23
Atascosa,18,State Senate,19,DEM,Freddy Ramirez,46,12,2,0,0,60,14,46
Atascosa,19,State Senate,19,DEM,Freddy Ramirez,5,6,1,0,0,12,7,5
Atascosa,20,State Senate,19,DEM,Freddy Ramirez,24,14,5,0,0,43,19,24
Atascosa,21,State Senate,19,DEM,Freddy Ramirez,0,0,0,0,0,0,0,0
Atascosa,22,State Senate,19,DEM,Freddy Ramirez,1,2,0,0,0,3,2,1
Atascosa,23,State Senate,19,DEM,Freddy Ramirez,9,1,3,0,0,13,4,9
Atascosa,24,State Senate,19,DEM,Freddy Ramirez,17,3,1,0,0,21,4,17
Atascosa,1,State Senate,19,DEM,Xochil Pena Rodriguez,14,8,0,0,0,22,8,14
Atascosa,2,State Senate,19,DEM,Xochil Pena Rodriguez,20,7,5,0,0,32,12,20
Atascosa,3,State Senate,19,DEM,Xochil Pena Rodriguez,28,11,4,1,0,44,15,29
Atascosa,4,State Senate,19,DEM,Xochil Pena Rodriguez,0,0,0,0,0,0,0,0
Atascosa,5,State Senate,19,DEM,Xochil Pena Rodriguez,31,24,7,0,0,62,31,31
Atascosa,6,State Senate,19,DEM,Xochil Pena Rodriguez,0,0,0,0,0,0,0,0
Atascosa,7,State Senate,19,DEM,Xochil Pena Rodriguez,36,13,3,1,0,53,16,37
Atascosa,8,State Senate,19,DEM,Xochil Pena Rodriguez,9,7,1,0,0,17,8,9
Atascosa,9,State Senate,19,DEM,Xochil Pena Rodriguez,0,0,0,0,0,0,0,0
Atascosa,10,State Senate,19,DEM,Xochil Pena Rodriguez,29,15,1,0,0,45,16,29
Atascosa,11,State Senate,19,DEM,Xochil Pena Rodriguez,0,0,0,0,0,0,0,0
Atascosa,12,State Senate,19,DEM,Xochil Pena Rodriguez,24,10,5,0,0,39,15,24
Atascosa,13,State Senate,19,DEM,Xochil Pena Rodriguez,32,37,8,1,0,78,45,33
Atascosa,14,State Senate,19,DEM,Xochil Pena Rodriguez,12,5,0,0,0,17,5,12
Atascosa,15,State Senate,19,DEM,Xochil Pena Rodriguez,56,12,5,0,0,73,17,56
Atascosa,16,State Senate,19,DEM,Xochil Pena Rodriguez,3,4,1,0,0,8,5,3
Atascosa,17,State Senate,19,DEM,Xochil Pena Rodriguez,66,29,2,0,0,97,31,66
Atascosa,18,State Senate,19,DEM,Xochil Pena Rodriguez,54,25,7,0,0,86,32,54
Atascosa,19,State Senate,19,DEM,Xochil Pena Rodriguez,6,7,1,0,0,14,8,6
Atascosa,20,State Senate,19,DEM,Xochil Pena Rodriguez,42,35,11,0,0,88,46,42
Atascosa,21,State Senate,19,DEM,Xochil Pena Rodriguez,0,0,0,0,0,0,0,0
Atascosa,22,State Senate,19,DEM,Xochil Pena Rodriguez,10,4,0,0,0,14,4,10
Atascosa,23,State Senate,19,DEM,Xochil Pena Rodriguez,13,12,1,0,0,26,13,13
Atascosa,24,State Senate,19,DEM,Xochil Pena Rodriguez,49,26,6,0,0,81,32,49
Atascosa,1,State Senate,19,DEM,Over Votes,0,0,0,0,0,0,0,0
Atascosa,2,State Senate,19,DEM,Over Votes,0,0,0,0,0,0,0,0
Atascosa,3,State Senate,19,DEM,Over Votes,0,0,0,0,0,0,0,0
Atascosa,4,State Senate,19,DEM,Over Votes,0,0,0,0,0,0,0,0
Atascosa,5,State Senate,19,DEM,Over Votes,0,0,0,0,0,0,0,0
Atascosa,6,State Senate,19,DEM,Over Votes,0,0,0,0,0,0,0,0
Atascosa,7,State Senate,19,DEM,Over Votes,0,0,0,0,0,0,0,0
Atascosa,8,State Senate,19,DEM,Over Votes,0,0,0,0,0,0,0,0
Atascosa,9,State Senate,19,DEM,Over Votes,0,0,0,0,0,0,0,0
Atascosa,10,State Senate,19,DEM,Over Votes,0,0,0,0,0,0,0,0
Atascosa,11,State Senate,19,DEM,Over Votes,0,0,0,0,0,0,0,0
Atascosa,12,State Senate,19,DEM,Over Votes,0,0,0,0,0,0,0,0
Atascosa,13,State Senate,19,DEM,Over Votes,0,0,0,0,0,0,0,0
Atascosa,14,State Senate,19,DEM,Over Votes,0,0,0,0,0,0,0,0
Atascosa,15,State Senate,19,DEM,Over Votes,0,0,0,0,0,0,0,0
Atascosa,16,State Senate,19,DEM,Over Votes,0,0,0,0,0,0,0,0
Atascosa,17,State Senate,19,DEM,Over Votes,0,0,0,0,0,0,0,0
Atascosa,18,State Senate,19,DEM,Over Votes,0,0,0,0,0,0,0,0
Atascosa,19,State Senate,19,DEM,Over Votes,0,0,0,0,0,0,0,0
Atascosa,20,State Senate,19,DEM,Over Votes,0,0,0,0,0,0,0,0
Atascosa,21,State Senate,19,DEM,Over Votes,0,0,0,0,0,0,0,0
Atascosa,22,State Senate,19,DEM,Over Votes,0,0,0,0,0,0,0,0
Atascosa,23,State Senate,19,DEM,Over Votes,0,0,0,0,0,0,0,0
Atascosa,24,State Senate,19,DEM,Over Votes,0,0,0,0,0,0,0,0
Atascosa,1,State Senate,19,DEM,Under Votes,1,0,0,0,0,1,0,1
Atascosa,2,State Senate,19,DEM,Under Votes,3,1,2,0,0,6,3,3
Atascosa,3,State Senate,19,DEM,Under Votes,6,3,2,0,0,11,5,6
Atascosa,4,State Senate,19,DEM,Under Votes,0,0,0,0,0,0,0,0
Atascosa,5,State Senate,19,DEM,Under Votes,3,1,4,0,0,8,5,3
Atascosa,6,State Senate,19,DEM,Under Votes,0,0,0,0,0,0,0,0
Atascosa,7,State Senate,19,DEM,Under Votes,5,0,2,0,0,7,2,5
Atascosa,8,State Senate,19,DEM,Under Votes,3,2,0,0,0,5,2,3
Atascosa,9,State Senate,19,DEM,Under Votes,0,0,0,0,0,0,0,0
Atascosa,10,State Senate,19,DEM,Under Votes,6,4,2,0,0,12,6,6
Atascosa,11,State Senate,19,DEM,Under Votes,0,0,0,0,0,0,0,0
Atascosa,12,State Senate,19,DEM,Under Votes,1,5,0,0,0,6,5,1
Atascosa,13,State Senate,19,DEM,Under Votes,5,6,0,0,0,11,6,5
Atascosa,14,State Senate,19,DEM,Under Votes,7,2,0,0,0,9,2,7
Atascosa,15,State Senate,19,DEM,Under Votes,4,3,2,0,1,10,5,4
Atascosa,16,State Senate,19,DEM,Under Votes,3,3,2,0,0,8,5,3
Atascosa,17,State Senate,19,DEM,Under Votes,21,4,2,0,0,27,6,21
Atascosa,18,State Senate,19,DEM,Under Votes,41,11,3,0,0,55,14,41
Atascosa,19,State Senate,19,DEM,Under Votes,1,5,0,0,0,6,5,1
Atascosa,20,State Senate,19,DEM,Under Votes,12,13,2,1,0,28,15,13
Atascosa,21,State Senate,19,DEM,Under Votes,0,0,0,0,0,0,0,0
Atascosa,22,State Senate,19,DEM,Under Votes,1,0,2,0,0,3,2,1
Atascosa,23,State Senate,19,DEM,Under Votes,1,0,0,0,0,1,0,1
Atascosa,24,State Senate,19,DEM,Under Votes,9,4,2,1,0,16,6,10
Atascosa,1,State Senate,21,DEM,Judith Zaffirini,0,0,0,0,0,0,0,0
Atascosa,2,State Senate,21,DEM,Judith Zaffirini,0,0,0,0,0,0,0,0
Atascosa,3,State Senate,21,DEM,Judith Zaffirini,0,0,0,0,0,0,0,0
Atascosa,4,State Senate,21,DEM,Judith Zaffirini,11,1,2,0,0,14,3,11
Atascosa,5,State Senate,21,DEM,Judith Zaffirini,0,0,0,0,0,0,0,0
Atascosa,6,State Senate,21,DEM,Judith Zaffirini,2,2,2,0,0,6,4,2
Atascosa,7,State Senate,21,DEM,Judith Zaffirini,0,0,0,0,0,0,0,0
Atascosa,8,State Senate,21,DEM,Judith Zaffirini,0,0,0,0,0,0,0,0
Atascosa,9,State Senate,21,DEM,Judith Zaffirini,6,0,2,0,0,8,2,6
Atascosa,10,State Senate,21,DEM,Judith Zaffirini,0,0,0,0,0,0,0,0
Atascosa,11,State Senate,21,DEM,Judith Zaffirini,3,0,3,0,0,6,3,3
Atascosa,12,State Senate,21,DEM,Judith Zaffirini,0,0,0,0,0,0,0,0
Atascosa,13,State Senate,21,DEM,Judith Zaffirini,0,0,0,0,0,0,0,0
Atascosa,14,State Senate,21,DEM,Judith Zaffirini,0,0,0,0,0,0,0,0
Atascosa,15,State Senate,21,DEM,Judith Zaffirini,0,0,0,0,0,0,0,0
Atascosa,16,State Senate,21,DEM,Judith Zaffirini,0,0,0,0,0,0,0,0
Atascosa,17,State Senate,21,DEM,Judith Zaffirini,0,0,0,0,0,0,0,0
Atascosa,18,State Senate,21,DEM,Judith Zaffirini,0,0,0,0,0,0,0,0
Atascosa,19,State Senate,21,DEM,Judith Zaffirini,0,0,0,0,0,0,0,0
Atascosa,20,State Senate,21,DEM,Judith Zaffirini,0,0,0,0,0,0,0,0
Atascosa,21,State Senate,21,DEM,Judith Zaffirini,9,5,0,0,0,14,5,9
Atascosa,22,State Senate,21,DEM,Judith Zaffirini,0,0,0,0,0,0,0,0
Atascosa,23,State Senate,21,DEM,Judith Zaffirini,0,0,0,0,0,0,0,0
Atascosa,24,State Senate,21,DEM,Judith Zaffirini,0,0,0,0,0,0,0,0
Atascosa,1,State Senate,21,DEM,Over Votes,0,0,0,0,0,0,0,0
Atascosa,2,State Senate,21,DEM,Over Votes,0,0,0,0,0,0,0,0
Atascosa,3,State Senate,21,DEM,Over Votes,0,0,0,0,0,0,0,0
Atascosa,4,State Senate,21,DEM,Over Votes,0,0,0,0,0,0,0,0
Atascosa,5,State Senate,21,DEM,Over Votes,0,0,0,0,0,0,0,0
Atascosa,6,State Senate,21,DEM,Over Votes,0,0,0,0,0,0,0,0
Atascosa,7,State Senate,21,DEM,Over Votes,0,0,0,0,0,0,0,0
Atascosa,8,State Senate,21,DEM,Over Votes,0,0,0,0,0,0,0,0
Atascosa,9,State Senate,21,DEM,Over Votes,0,0,0,0,0,0,0,0
Atascosa,10,State Senate,21,DEM,Over Votes,0,0,0,0,0,0,0,0
Atascosa,11,State Senate,21,DEM,Over Votes,0,0,0,0,0,0,0,0
Atascosa,12,State Senate,21,DEM,Over Votes,0,0,0,0,0,0,0,0
Atascosa,13,State Senate,21,DEM,Over Votes,0,0,0,0,0,0,0,0
Atascosa,14,State Senate,21,DEM,Over Votes,0,0,0,0,0,0,0,0
Atascosa,15,State Senate,21,DEM,Over Votes,0,0,0,0,0,0,0,0
Atascosa,16,State Senate,21,DEM,Over Votes,0,0,0,0,0,0,0,0
Atascosa,17,State Senate,21,DEM,Over Votes,0,0,0,0,0,0,0,0
Atascosa,18,State Senate,21,DEM,Over Votes,0,0,0,0,0,0,0,0
Atascosa,19,State Senate,21,DEM,Over Votes,0,0,0,0,0,0,0,0
Atascosa,20,State Senate,21,DEM,Over Votes,0,0,0,0,0,0,0,0
Atascosa,21,State Senate,21,DEM,Over Votes,0,0,0,0,0,0,0,0
Atascosa,22,State Senate,21,DEM,Over Votes,0,0,0,0,0,0,0,0
Atascosa,23,State Senate,21,DEM,Over Votes,0,0,0,0,0,0,0,0
Atascosa,24,State Senate,21,DEM,Over Votes,0,0,0,0,0,0,0,0
Atascosa,1,State Senate,21,DEM,Under Votes,0,0,0,0,0,0,0,0
Atascosa,2,State Senate,21,DEM,Under Votes,0,0,0,0,0,0,0,0
Atascosa,3,State Senate,21,DEM,Under Votes,0,0,0,0,0,0,0,0
Atascosa,4,State Senate,21,DEM,Under Votes,3,0,0,0,0,3,0,3
Atascosa,5,State Senate,21,DEM,Under Votes,0,0,0,0,0,0,0,0
Atascosa,6,State Senate,21,DEM,Under Votes,0,0,0,0,0,0,0,0
Atascosa,7,State Senate,21,DEM,Under Votes,0,0,0,0,0,0,0,0
Atascosa,8,State Senate,21,DEM,Under Votes,0,0,0,0,0,0,0,0
Atascosa,9,State Senate,21,DEM,Under Votes,0,0,0,0,0,0,0,0
Atascosa,10,State Senate,21,DEM,Under Votes,0,0,0,0,0,0,0,0
Atascosa,11,State Senate,21,DEM,Under Votes,0,0,0,0,0,0,0,0
Atascosa,12,State Senate,21,DEM,Under Votes,0,0,0,0,0,0,0,0
Atascosa,13,State Senate,21,DEM,Under Votes,0,0,0,0,0,0,0,0
Atascosa,14,State Senate,21,DEM,Under Votes,0,0,0,0,0,0,0,0
Atascosa,15,State Senate,21,DEM,Under Votes,0,0,0,0,0,0,0,0
Atascosa,16,State Senate,21,DEM,Under Votes,0,0,0,0,0,0,0,0
Atascosa,17,State Senate,21,DEM,Under Votes,0,0,0,0,0,0,0,0
Atascosa,18,State Senate,21,DEM,Under Votes,0,0,0,0,0,0,0,0
Atascosa,19,State Senate,21,DEM,Under Votes,0,0,0,0,0,0,0,0
Atascosa,20,State Senate,21,DEM,Under Votes,0,0,0,0,0,0,0,0
Atascosa,21,State Senate,21,DEM,Under Votes,3,0,0,0,0,3,0,3
Atascosa,22,State Senate,21,DEM,Under Votes,0,0,0,0,0,0,0,0
Atascosa,23,State Senate,21,DEM,Under Votes,0,0,0,0,0,0,0,0
Atascosa,24,State Senate,21,DEM,Under Votes,0,0,0,0,0,0,0,0
Atascosa,1,State Representative,31,DEM,Ryan Guillen,29,21,6,0,0,56,27,29
Atascosa,2,State Representative,31,DEM,Ryan Guillen,44,14,9,0,0,67,23,44
Atascosa,3,State Representative,31,DEM,Ryan Guillen,77,48,20,1,0,146,68,78
Atascosa,4,State Representative,31,DEM,Ryan Guillen,11,1,2,0,0,14,3,11
Atascosa,5,State Representative,31,DEM,Ryan Guillen,76,46,15,2,0,139,61,78
Atascosa,6,State Representative,31,DEM,Ryan Guillen,2,2,2,0,0,6,4,2
Atascosa,7,State Representative,31,DEM,Ryan Guillen,78,24,10,1,0,113,34,79
Atascosa,8,State Representative,31,DEM,Ryan Guillen,32,23,0,0,0,55,23,32
Atascosa,9,State Representative,31,DEM,Ryan Guillen,6,0,2,0,0,8,2,6
Atascosa,10,State Representative,31,DEM,Ryan Guillen,80,34,6,0,0,120,40,80
Atascosa,11,State Representative,31,DEM,Ryan Guillen,3,0,3,0,0,6,3,3
Atascosa,12,State Representative,31,DEM,Ryan Guillen,55,24,12,0,0,91,36,55
Atascosa,13,State Representative,31,DEM,Ryan Guillen,99,108,37,1,0,245,145,100
Atascosa,14,State Representative,31,DEM,Ryan Guillen,30,19,7,0,0,56,26,30
Atascosa,15,State Representative,31,DEM,Ryan Guillen,121,45,36,0,0,202,81,121
Atascosa,16,State Representative,31,DEM,Ryan Guillen,12,10,1,0,0,23,11,12
Atascosa,17,State Representative,31,DEM,Ryan Guillen,194,125,21,2,0,342,146,196
Atascosa,18,State Representative,31,DEM,Ryan Guillen,163,54,23,0,0,240,77,163
Atascosa,19,State Representative,31,DEM,Ryan Guillen,15,26,6,0,0,47,32,15
Atascosa,20,State Representative,31,DEM,Ryan Guillen,143,114,23,1,0,281,137,144
Atascosa,21,State Representative,31,DEM,Ryan Guillen,10,5,0,0,0,15,5,10
Atascosa,22,State Representative,31,DEM,Ryan Guillen,26,16,5,0,0,47,21,26
Atascosa,23,State Representative,31,DEM,Ryan Guillen,38,17,9,0,0,64,26,38
Atascosa,24,State Representative,31,DEM,Ryan Guillen,88,53,11,1,0,153,64,89
Atascosa,1,State Representative,31,DEM,Over Votes,0,0,0,0,0,0,0,0
Atascosa,2,State Representative,31,DEM,Over Votes,0,0,0,0,0,0,0,0
Atascosa,3,State Representative,31,DEM,Over Votes,0,0,0,0,0,0,0,0
Atascosa,4,State Representative,31,DEM,Over Votes,0,0,0,0,0,0,0,0
Atascosa,5,State Representative,31,DEM,Over Votes,0,0,0,0,0,0,0,0
Atascosa,6,State Representative,31,DEM,Over Votes,0,0,0,0,0,0,0,0
Atascosa,7,State Representative,31,DEM,Over Votes,0,0,0,0,0,0,0,0
Atascosa,8,State Representative,31,DEM,Over Votes,0,0,0,0,0,0,0,0
Atascosa,9,State Representative,31,DEM,Over Votes,0,0,0,0,0,0,0,0
Atascosa,10,State Representative,31,DEM,Over Votes,0,0,0,0,0,0,0,0
Atascosa,11,State Representative,31,DEM,Over Votes,0,0,0,0,0,0,0,0
Atascosa,12,State Representative,31,DEM,Over Votes,0,0,0,0,0,0,0,0
Atascosa,13,State Representative,31,DEM,Over Votes,0,0,0,0,0,0,0,0
Atascosa,14,State Representative,31,DEM,Over Votes,0,0,0,0,0,0,0,0
Atascosa,15,State Representative,31,DEM,Over Votes,0,0,0,0,0,0,0,0
Atascosa,16,State Representative,31,DEM,Over Votes,0,0,0,0,0,0,0,0
Atascosa,17,State Representative,31,DEM,Over Votes,0,0,0,0,0,0,0,0
Atascosa,18,State Representative,31,DEM,Over Votes,0,0,0,0,0,0,0,0
Atascosa,19,State Representative,31,DEM,Over Votes,0,0,0,0,0,0,0,0
Atascosa,20,State Representative,31,DEM,Over Votes,0,0,0,0,0,0,0,0
Atascosa,21,State Representative,31,DEM,Over Votes,0,0,0,0,0,0,0,0
Atascosa,22,State Representative,31,DEM,Over Votes,0,0,0,0,0,0,0,0
Atascosa,23,State Representative,31,DEM,Over Votes,0,0,0,0,0,0,0,0
Atascosa,24,State Representative,31,DEM,Over Votes,0,0,0,0,0,0,0,0
Atascosa,1,State Representative,31,DEM,Under Votes,0,1,0,0,0,1,1,0
Atascosa,2,State Representative,31,DEM,Under Votes,6,1,5,0,0,12,6,6
Atascosa,3,State Representative,31,DEM,Under Votes,4,3,1,0,0,8,4,4
Atascosa,4,State Representative,31,DEM,Under Votes,3,0,0,0,0,3,0,3
Atascosa,5,State Representative,31,DEM,Under Votes,9,3,4,0,0,16,7,9
Atascosa,6,State Representative,31,DEM,Under Votes,0,0,0,0,0,0,0,0
Atascosa,7,State Representative,31,DEM,Under Votes,7,3,3,0,0,13,6,7
Atascosa,8,State Representative,31,DEM,Under Votes,4,3,1,0,0,8,4,4
Atascosa,9,State Representative,31,DEM,Under Votes,0,0,0,0,0,0,0,0
Atascosa,10,State Representative,31,DEM,Under Votes,7,4,0,0,0,11,4,7
Atascosa,11,State Representative,31,DEM,Under Votes,0,0,0,0,0,0,0,0
Atascosa,12,State Representative,31,DEM,Under Votes,4,5,4,1,0,14,9,5
Atascosa,13,State Representative,31,DEM,Under Votes,6,4,0,0,0,10,4,6
Atascosa,14,State Representative,31,DEM,Under Votes,6,3,0,0,0,9,3,6
Atascosa,15,State Representative,31,DEM,Under Votes,9,2,5,0,1,17,7,9
Atascosa,16,State Representative,31,DEM,Under Votes,2,2,2,0,0,6,4,2
Atascosa,17,State Representative,31,DEM,Under Votes,36,15,7,0,0,58,22,36
Atascosa,18,State Representative,31,DEM,Under Votes,54,11,3,0,0,68,14,54
Atascosa,19,State Representative,31,DEM,Under Votes,2,4,0,0,0,6,4,2
Atascosa,20,State Representative,31,DEM,Under Votes,7,12,2,0,0,21,14,7
Atascosa,21,State Representative,31,DEM,Under Votes,2,0,0,0,0,2,0,2
Atascosa,22,State Representative,31,DEM,Under Votes,2,1,0,0,0,3,1,2
Atascosa,23,State Representative,31,DEM,Under Votes,6,1,0,0,0,7,1,6
Atascosa,24,State Representative,31,DEM,Under Votes,12,4,2,0,0,18,6,12