precinct,office,district,party,candidate,mail,early_voting,election_day,votes
1,President,,DEM,CORY BOOKER,1,2,2,5
1,President,,DEM,MICHAEL R. BLOOMBERG,16,62,45,123
1,President,,DEM,"ROQUE ""ROCKY"" DE LA FUENTE",1,9,3,13
1,President,,DEM,MICHAEL BENNET,1,1,0,2
1,President,,DEM,ROBBY WELLS,0,5,0,5
1,President,,DEM,TULSI GABBARD,0,2,1,3
1,President,,DEM,JOSEPH R. BIDEN,8,25,39,72
1,President,,DEM,ANDREW YANG,0,3,0,3
1,President,,DEM,JOHN K. DELANEY,2,1,2,5
1,President,,DEM,TOM STEYER,0,9,1,10
1,President,,DEM,DEVAL PATRICK,0,1,0,1
1,President,,DEM,PETE BUTTIGIEG,0,4,1,5
1,President,,DEM,ELIZABETH WARREN,4,7,14,25
1,President,,DEM,AMY KLOBUCHAR,1,7,3,11
1,President,,DEM,MARIANNE WILLIAMSON,0,0,0,0
1,President,,DEM,JULIAN CASTRO,6,24,16,46
1,President,,DEM,BERNIE SANDERS,11,64,50,125
1,U.S. Senate,,DEM,MICHAEL COPPER,7,28,7,42
1,U.S. Senate,,DEM,SEMA HERNANDEZ,0,39,28,67
1,U.S. Senate,,DEM,AMANDA K. EDWARDS,1,7,4,12
1,U.S. Senate,,DEM,"MARY ""MJ"" HEGAR",4,13,7,24
1,U.S. Senate,,DEM,CHRIS BELL,1,18,18,37
1,U.S. Senate,,DEM,ROYCE WEST,0,4,1,5
1,U.S. Senate,,DEM,ADRIAN OCEGUEDA,1,4,4,9
1,U.S. Senate,,DEM,"JACK DANIEL FOSTER, JR",4,4,0,8
1,U.S. Senate,,DEM,VICTOR HUGO HARRIS,0,3,4,7
1,U.S. Senate,,DEM,"ANNIE ""MAMA"" GARCIA",3,30,29,62
1,U.S. Senate,,DEM,D. R. HUNTER,1,2,4,7
1,U.S. Senate,,DEM,CRISTINA TZINTZUN RAMIREZ,16,50,42,108
1,U.S. House,23,DEM,JAMIE ESCUDER,1,16,4,21
1,U.S. House,23,DEM,EFRAIN V. VALDEZ,0,24,18,42
1,U.S. House,23,DEM,GINA ORTIZ JONES,40,141,114,295
1,U.S. House,23,DEM,RICARDO R. MADRID,2,12,8,22
1,U.S. House,23,DEM,"ROSALINA ""ROSEY"" RAMOS ABUABARA",3,21,18,42
1,Railroad Commissioner,,DEM,MARK WATSON ,6,29,21,56
1,Railroad Commissioner,,DEM,KELLEY STONE,6,32,18,56
1,Railroad Commissioner,,DEM,"ROBERTO R. ""BETO"" ALONZO",18,108,68,194
1,Railroad Commissioner,,DEM,CHRYSTA CASTANEDA,9,35,46,90
1,"CHIEF JUSTICE, SUPREME COURT",,DEM,JERRY ZIMMERER,14,89,60,163
1,"CHIEF JUSTICE, SUPREME COURT",,DEM,AMY CLARK MEACHUM,21,96,78,195
1,"JUSTICE, SUPREME COURT, PLACE 6",,DEM,KATHY CHENG,24,109,96,229
1,"JUSTICE, SUPREME COURT, PLACE 6",,DEM,LARRY PRAEGER,12,79,41,132
1,"JUSTICE, SUPREME COURT, PLACE 7",,DEM,STACI WILLIAMS,22,105,81,208
1,"JUSTICE, SUPREME COURT, PLACE 7",,DEM,BRANDY VOSS,16,82,57,155
1,"JUSTICE, SUPREME COURT, PLACE 8",,DEM,GISLA D. TRIANA,24,120,96,240
1,"JUSTICE, SUPREME COURT, PLACE 8",,DEM,PETER KELLY,12,64,44,120
1,"JUDGE, COURT OF CRIMINAL APPEALS, PL 3",,DEM,ELIZABETH DAVIS FRIZELL,21,97,83,201
1,"JUDGE, COURT OF CRIMINAL APPEALS, PL 3",,DEM,WILLIAM PIERATT DEMOND,3,32,16,51
1,"JUDGE, COURT OF CRIMINAL APPEALS, PL 3",,DEM,DAN WOOD,13,54,44,111
1,"JUDGE, COURT OF CRIMINAL APPEALS, PL 4",,DEM,TINA CLINTON,29,122,97,248
1,"JUDGE, COURT OF CRIMINAL APPEALS, PL 4",,DEM,STEVEN MIEARS,10,64,42,116
1,"JUDGE, COURT OF CRIMINAL APPEALS, PL 9",,DEM,BRANDON BIRMINGHAM,29,135,113,277
1,"MEMBER, STATE BOE, DISTRICT 1",,DEM,GEORGINA PEREZ,32,147,121,300
1,State Senate,19,DEM,FREDDY RAMIREZ,2,42,32,76
1,State Senate,19,DEM,ROLAND GUTIERREZ,31,98,85,214
1,State Senate,19,DEM,XOCHIL PENA RODRIGUEZ,17,57,45,119
1,State Representative,80,DEM,TRACY KING ,62,181,138,381
1,State Representative,80,DEM,DANNY VALDEZ,7,63,57,127
1,"CHIEF JUSTICE, 4TH COURT OF APPLEALS DIST",,DEM,REBECA MARTINEZ,34,154,125,313
2,President,,DEM,CORY BOOKER,1,1,0,2
2,President,,DEM,MICHAEL R. BLOOMBERG,7,28,30,65
2,President,,DEM,"ROQUE ""ROCKY"" DE LA FUENTE",1,5,0,6
2,President,,DEM,MICHAEL BENNET,0,1,2,3
2,President,,DEM,ROBBY WELLS,1,0,1,2
2,President,,DEM,TULSI GABBARD,0,2,0,2
2,President,,DEM,JOSEPH R. BIDEN,7,12,32,51
2,President,,DEM,ANDREW YANG,0,2,0,2
2,President,,DEM,JOHN K. DELANEY,0,1,0,1
2,President,,DEM,TOM STEYER,1,2,2,5
2,President,,DEM,DEVAL PATRICK,0,2,0,2
2,President,,DEM,PETE BUTTIGIEG,2,5,1,8
2,President,,DEM,ELIZABETH WARREN,1,11,11,23
2,President,,DEM,AMY KLOBUCHAR,2,2,1,5
2,President,,DEM,MARIANNE WILLIAMSON,0,1,0,1
2,President,,DEM,JULIAN CASTRO,5,18,14,37
2,President,,DEM,BERNIE SANDERS,23,41,26,90
2,U.S. Senate,,DEM,MICHAEL COPPER,1,8,10,19
2,U.S. Senate,,DEM,SEMA HERNANDEZ,3,24,15,42
2,U.S. Senate,,DEM,AMANDA K. EDWARDS,0,4,4,8
2,U.S. Senate,,DEM,"MARY ""MJ"" HEGAR",3,11,8,22
2,U.S. Senate,,DEM,CHRIS BELL,0,5,7,12
2,U.S. Senate,,DEM,ROYCE WEST,0,4,3,7
2,U.S. Senate,,DEM,ADRIAN OCEGUEDA,0,2,1,3
2,U.S. Senate,,DEM,"JACK DANIEL FOSTER, JR",1,0,0,1
2,U.S. Senate,,DEM,VICTOR HUGO HARRIS,1,2,2,5
2,U.S. Senate,,DEM,"ANNIE ""MAMA"" GARCIA",6,22,14,42
2,U.S. Senate,,DEM,D. R. HUNTER,0,2,1,3
2,U.S. Senate,,DEM,CRISTINA TZINTZUN RAMIREZ,16,24,30,70
2,U.S. House,23,DEM,JAMIE ESCUDER,1,4,3,8
2,U.S. House,23,DEM,EFRAIN V. VALDEZ,2,18,10,30
2,U.S. House,23,DEM,GINA ORTIZ JONES,37,83,74,194
2,U.S. House,23,DEM,RICARDO R. MADRID,0,14,7,21
2,U.S. House,23,DEM,"ROSALINA ""ROSEY"" RAMOS ABUABARA",1,8,14,23
2,Railroad Commissioner,,DEM,MARK WATSON ,7,19,12,38
2,Railroad Commissioner,,DEM,KELLEY STONE,6,21,13,40
2,Railroad Commissioner,,DEM,"ROBERTO R. ""BETO"" ALONZO",16,56,45,117
2,Railroad Commissioner,,DEM,CHRYSTA CASTANEDA,4,20,25,49
2,"CHIEF JUSTICE, SUPREME COURT",,DEM,JERRY ZIMMERER,19,51,33,103
2,"CHIEF JUSTICE, SUPREME COURT",,DEM,AMY CLARK MEACHUM,13,49,45,107
2,"JUSTICE, SUPREME COURT, PLACE 6",,DEM,KATHY CHENG,19,68,52,139
2,"JUSTICE, SUPREME COURT, PLACE 6",,DEM,LARRY PRAEGER,12,40,27,79
2,"JUSTICE, SUPREME COURT, PLACE 7",,DEM,STACI WILLIAMS,23,65,51,139
2,"JUSTICE, SUPREME COURT, PLACE 7",,DEM,BRANDY VOSS,8,39,33,80
2,"JUSTICE, SUPREME COURT, PLACE 8",,DEM,GISLA D. TRIANA,21,63,52,136
2,"JUSTICE, SUPREME COURT, PLACE 8",,DEM,PETER KELLY,12,37,28,77
2,"JUDGE, COURT OF CRIMINAL APPEALS, PL 3",,DEM,ELIZABETH DAVIS FRIZELL,16,59,45,120
2,"JUDGE, COURT OF CRIMINAL APPEALS, PL 3",,DEM,WILLIAM PIERATT DEMOND,7,11,17,35
2,"JUDGE, COURT OF CRIMINAL APPEALS, PL 3",,DEM,DAN WOOD,11,32,16,59
2,"JUDGE, COURT OF CRIMINAL APPEALS, PL 4",,DEM,TINA CLINTON,22,75,61,158
2,"JUDGE, COURT OF CRIMINAL APPEALS, PL 4",,DEM,STEVEN MIEARS,11,36,20,67
2,"JUDGE, COURT OF CRIMINAL APPEALS, PL 9",,DEM,BRANDON BIRMINGHAM,25,84,60,169
2,"MEMBER, STATE BOE, DISTRICT 1",,DEM,GEORGINA PEREZ,25,84,65,174
2,State Senate,19,DEM,FREDDY RAMIREZ,6,20,19,45
2,State Senate,19,DEM,ROLAND GUTIERREZ,21,67,52,140
2,State Senate,19,DEM,XOCHIL PENA RODRIGUEZ,11,41,35,87
2,State Representative,80,DEM,TRACY KING ,56,108,102,266
2,State Representative,80,DEM,DANNY VALDEZ,6,36,27,69
2,"CHIEF JUSTICE, 4TH COURT OF APPLEALS DIST",,DEM,REBECA MARTINEZ,25,87,69,181
3,President,,DEM,CORY BOOKER,0,1,0,1
3,President,,DEM,MICHAEL R. BLOOMBERG,14,22,37,73
3,President,,DEM,"ROQUE ""ROCKY"" DE LA FUENTE",0,0,2,2
3,President,,DEM,MICHAEL BENNET,0,1,0,1
3,President,,DEM,ROBBY WELLS,0,0,0,0
3,President,,DEM,TULSI GABBARD,0,0,0,0
3,President,,DEM,JOSEPH R. BIDEN,9,15,35,59
3,President,,DEM,ANDREW YANG,0,0,0,0
3,President,,DEM,JOHN K. DELANEY,1,2,0,3
3,President,,DEM,TOM STEYER,0,1,2,3
3,President,,DEM,DEVAL PATRICK,0,0,0,0
3,President,,DEM,PETE BUTTIGIEG,4,2,0,6
3,President,,DEM,ELIZABETH WARREN,3,1,11,15
3,President,,DEM,AMY KLOBUCHAR,1,4,0,5
3,President,,DEM,MARIANNE WILLIAMSON,0,0,0,0
3,President,,DEM,JULIAN CASTRO,7,16,15,38
3,President,,DEM,BERNIE SANDERS,19,45,36,100
3,U.S. Senate,,DEM,MICHAEL COPPER,4,4,6,14
3,U.S. Senate,,DEM,SEMA HERNANDEZ,4,17,14,35
3,U.S. Senate,,DEM,AMANDA K. EDWARDS,3,4,3,10
3,U.S. Senate,,DEM,"MARY ""MJ"" HEGAR",5,8,3,16
3,U.S. Senate,,DEM,CHRIS BELL,0,1,5,6
3,U.S. Senate,,DEM,ROYCE WEST,3,3,4,10
3,U.S. Senate,,DEM,ADRIAN OCEGUEDA,0,2,3,5
3,U.S. Senate,,DEM,"JACK DANIEL FOSTER, JR",2,3,2,7
3,U.S. Senate,,DEM,VICTOR HUGO HARRIS,0,2,4,6
3,U.S. Senate,,DEM,"ANNIE ""MAMA"" GARCIA",7,14,21,42
3,U.S. Senate,,DEM,D. R. HUNTER,0,2,0,2
3,U.S. Senate,,DEM,CRISTINA TZINTZUN RAMIREZ,11,27,49,87
3,U.S. House,23,DEM,JAMIE ESCUDER,4,2,6,12
3,U.S. House,23,DEM,EFRAIN V. VALDEZ,2,9,22,33
3,U.S. House,23,DEM,GINA ORTIZ JONES,39,79,75,193
3,U.S. House,23,DEM,RICARDO R. MADRID,0,2,5,7
3,U.S. House,23,DEM,"ROSALINA ""ROSEY"" RAMOS ABUABARA",2,6,18,26
3,Railroad Commissioner,,DEM,MARK WATSON ,5,8,8,21
3,Railroad Commissioner,,DEM,KELLEY STONE,4,9,16,29
3,Railroad Commissioner,,DEM,"ROBERTO R. ""BETO"" ALONZO",20,48,57,125
3,Railroad Commissioner,,DEM,CHRYSTA CASTANEDA,11,19,26,56
3,"CHIEF JUSTICE, SUPREME COURT",,DEM,JERRY ZIMMERER,13,37,43,93
3,"CHIEF JUSTICE, SUPREME COURT",,DEM,AMY CLARK MEACHUM,24,41,51,116
3,"JUSTICE, SUPREME COURT, PLACE 6",,DEM,KATHY CHENG,18,60,67,145
3,"JUSTICE, SUPREME COURT, PLACE 6",,DEM,LARRY PRAEGER,20,22,25,67
3,"JUSTICE, SUPREME COURT, PLACE 7",,DEM,STACI WILLIAMS,25,48,53,126
3,"JUSTICE, SUPREME COURT, PLACE 7",,DEM,BRANDY VOSS,11,33,35,79
3,"JUSTICE, SUPREME COURT, PLACE 8",,DEM,GISLA D. TRIANA,30,64,70,164
3,"JUSTICE, SUPREME COURT, PLACE 8",,DEM,PETER KELLY,8,21,25,54
3,"JUDGE, COURT OF CRIMINAL APPEALS, PL 3",,DEM,ELIZABETH DAVIS FRIZELL,18,57,60,135
3,"JUDGE, COURT OF CRIMINAL APPEALS, PL 3",,DEM,WILLIAM PIERATT DEMOND,9,11,9,29
3,"JUDGE, COURT OF CRIMINAL APPEALS, PL 3",,DEM,DAN WOOD,9,13,25,47
3,"JUDGE, COURT OF CRIMINAL APPEALS, PL 4",,DEM,TINA CLINTON,28,62,72,162
3,"JUDGE, COURT OF CRIMINAL APPEALS, PL 4",,DEM,STEVEN MIEARS,11,20,21,52
3,"JUDGE, COURT OF CRIMINAL APPEALS, PL 9",,DEM,BRANDON BIRMINGHAM,29,56,74,159
3,"MEMBER, STATE BOE, DISTRICT 1",,DEM,GEORGINA PEREZ,28,62,76,166
3,State Senate,19,DEM,FREDDY RAMIREZ,3,16,23,42
3,State Senate,19,DEM,ROLAND GUTIERREZ,32,41,58,131
3,State Senate,19,DEM,XOCHIL PENA RODRIGUEZ,19,37,45,101
3,State Representative,80,DEM,TRACY KING ,57,89,98,244
3,State Representative,80,DEM,DANNY VALDEZ,12,27,46,85
3,"CHIEF JUSTICE, 4TH COURT OF APPLEALS DIST",,DEM,REBECA MARTINEZ,36,69,85,190
4,President,,DEM,CORY BOOKER,0,2,0,2
4,President,,DEM,MICHAEL R. BLOOMBERG,13,34,38,85
4,President,,DEM,"ROQUE ""ROCKY"" DE LA FUENTE",0,6,5,11
4,President,,DEM,MICHAEL BENNET,0,1,0,1
4,President,,DEM,ROBBY WELLS,1,6,0,7
4,President,,DEM,TULSI GABBARD,0,12,3,15
4,President,,DEM,JOSEPH R. BIDEN,7,31,47,85
4,President,,DEM,ANDREW YANG,0,10,2,12
4,President,,DEM,JOHN K. DELANEY,0,2,2,4
4,President,,DEM,TOM STEYER,2,5,7,14
4,President,,DEM,DEVAL PATRICK,0,2,1,3
4,President,,DEM,PETE BUTTIGIEG,1,9,1,11
4,President,,DEM,ELIZABETH WARREN,1,15,7,23
4,President,,DEM,AMY KLOBUCHAR,0,10,5,15
4,President,,DEM,MARIANNE WILLIAMSON,0,2,2,4
4,President,,DEM,JULIAN CASTRO,2,22,18,42
4,President,,DEM,BERNIE SANDERS,9,58,39,106
4,U.S. Senate,,DEM,MICHAEL COPPER,0,13,14,27
4,U.S. Senate,,DEM,SEMA HERNANDEZ,7,28,20,55
4,U.S. Senate,,DEM,AMANDA K. EDWARDS,2,11,9,22
4,U.S. Senate,,DEM,"MARY ""MJ"" HEGAR",7,11,7,25
4,U.S. Senate,,DEM,CHRIS BELL,0,28,18,46
4,U.S. Senate,,DEM,ROYCE WEST,0,10,8,18
4,U.S. Senate,,DEM,ADRIAN OCEGUEDA,2,4,4,10
4,U.S. Senate,,DEM,"JACK DANIEL FOSTER, JR",1,6,8,15
4,U.S. Senate,,DEM,VICTOR HUGO HARRIS,0,5,3,8
4,U.S. Senate,,DEM,"ANNIE ""MAMA"" GARCIA",3,30,21,54
4,U.S. Senate,,DEM,D. R. HUNTER,1,10,5,16
4,U.S. Senate,,DEM,CRISTINA TZINTZUN RAMIREZ,11,23,36,70
4,U.S. House,23,DEM,JAMIE ESCUDER,0,11,15,26
4,U.S. House,23,DEM,EFRAIN V. VALDEZ,2,29,17,48
4,U.S. House,23,DEM,GINA ORTIZ JONES,25,114,109,248
4,U.S. House,23,DEM,RICARDO R. MADRID,3,26,7,36
4,U.S. House,23,DEM,"ROSALINA ""ROSEY"" RAMOS ABUABARA",3,29,17,49
4,Railroad Commissioner,,DEM,MARK WATSON ,3,54,43,100
4,Railroad Commissioner,,DEM,KELLEY STONE,2,26,18,46
4,Railroad Commissioner,,DEM,"ROBERTO R. ""BETO"" ALONZO",19,73,61,153
4,Railroad Commissioner,,DEM,CHRYSTA CASTANEDA,9,31,31,71
4,"CHIEF JUSTICE, SUPREME COURT",,DEM,JERRY ZIMMERER,13,92,78,183
4,"CHIEF JUSTICE, SUPREME COURT",,DEM,AMY CLARK MEACHUM,15,68,74,157
4,"JUSTICE, SUPREME COURT, PLACE 6",,DEM,KATHY CHENG,16,80,78,174
4,"JUSTICE, SUPREME COURT, PLACE 6",,DEM,LARRY PRAEGER,15,80,70,165
4,"JUSTICE, SUPREME COURT, PLACE 7",,DEM,STACI WILLIAMS,16,103,101,220
4,"JUSTICE, SUPREME COURT, PLACE 7",,DEM,BRANDY VOSS,14,62,45,121
4,"JUSTICE, SUPREME COURT, PLACE 8",,DEM,GISLA D. TRIANA,19,88,87,194
4,"JUSTICE, SUPREME COURT, PLACE 8",,DEM,PETER KELLY,12,75,51,138
4,"JUDGE, COURT OF CRIMINAL APPEALS, PL 3",,DEM,ELIZABETH DAVIS FRIZELL,16,82,85,183
4,"JUDGE, COURT OF CRIMINAL APPEALS, PL 3",,DEM,WILLIAM PIERATT DEMOND,3,18,18,39
4,"JUDGE, COURT OF CRIMINAL APPEALS, PL 3",,DEM,DAN WOOD,12,61,42,115
4,"JUDGE, COURT OF CRIMINAL APPEALS, PL 4",,DEM,TINA CLINTON,24,109,102,235
4,"JUDGE, COURT OF CRIMINAL APPEALS, PL 4",,DEM,STEVEN MIEARS,6,52,46,104
4,"JUDGE, COURT OF CRIMINAL APPEALS, PL 9",,DEM,BRANDON BIRMINGHAM,23,125,116,264
4,"MEMBER, STATE BOE, DISTRICT 1",,DEM,GEORGINA PEREZ,26,131,116,273
4,State Senate,19,DEM,FREDDY RAMIREZ,2,39,30,71
4,State Senate,19,DEM,ROLAND GUTIERREZ,21,83,73,177
4,State Senate,19,DEM,XOCHIL PENA RODRIGUEZ,11,59,51,121
4,State Representative,80,DEM,TRACY KING ,22,220,151,393
4,State Representative,80,DEM,DANNY VALDEZ,12,46,45,103
4,"CHIEF JUSTICE, 4TH COURT OF APPLEALS DIST",,DEM,REBECA MARTINEZ,25,136,119,280
5,President,,DEM,CORY BOOKER,0,0,0,0
5,President,,DEM,MICHAEL R. BLOOMBERG,3,2,3,8
5,President,,DEM,"ROQUE ""ROCKY"" DE LA FUENTE",0,0,0,0
5,President,,DEM,MICHAEL BENNET,0,0,0,0
5,President,,DEM,ROBBY WELLS,0,0,0,0
5,President,,DEM,TULSI GABBARD,0,1,1,2
5,President,,DEM,JOSEPH R. BIDEN,1,10,27,38
5,President,,DEM,ANDREW YANG,0,0,0,0
5,President,,DEM,JOHN K. DELANEY,0,0,0,0
5,President,,DEM,TOM STEYER,0,2,2,4
5,President,,DEM,DEVAL PATRICK,0,1,0,1
5,President,,DEM,PETE BUTTIGIEG,0,1,2,3
5,President,,DEM,ELIZABETH WARREN,0,0,7,7
5,President,,DEM,AMY KLOBUCHAR,0,5,1,6
5,President,,DEM,MARIANNE WILLIAMSON,0,0,1,1
5,President,,DEM,JULIAN CASTRO,0,0,0,0
5,President,,DEM,BERNIE SANDERS,4,4,5,13
5,U.S. Senate,,DEM,MICHAEL COPPER,0,1,8,9
5,U.S. Senate,,DEM,SEMA HERNANDEZ,0,4,1,5
5,U.S. Senate,,DEM,AMANDA K. EDWARDS,2,0,1,3
5,U.S. Senate,,DEM,"MARY ""MJ"" HEGAR",0,11,10,21
5,U.S. Senate,,DEM,CHRIS BELL,0,0,2,2
5,U.S. Senate,,DEM,ROYCE WEST,1,3,8,12
5,U.S. Senate,,DEM,ADRIAN OCEGUEDA,0,0,0,0
5,U.S. Senate,,DEM,"JACK DANIEL FOSTER, JR",0,2,2,4
5,U.S. Senate,,DEM,VICTOR HUGO HARRIS,0,0,0,0
5,U.S. Senate,,DEM,"ANNIE ""MAMA"" GARCIA",0,0,1,1
5,U.S. Senate,,DEM,D. R. HUNTER,0,0,1,1
5,U.S. Senate,,DEM,CRISTINA TZINTZUN RAMIREZ,3,2,14,19
5,U.S. House,23,DEM,JAMIE ESCUDER,0,2,8,10
5,U.S. House,23,DEM,EFRAIN V. VALDEZ,0,2,2,4
5,U.S. House,23,DEM,GINA ORTIZ JONES,7,18,32,57
5,U.S. House,23,DEM,RICARDO R. MADRID,0,0,4,4
5,U.S. House,23,DEM,"ROSALINA ""ROSEY"" RAMOS ABUABARA",0,2,2,4
5,Railroad Commissioner,,DEM,MARK WATSON ,3,10,17,30
5,Railroad Commissioner,,DEM,KELLEY STONE,0,5,11,16
5,Railroad Commissioner,,DEM,"ROBERTO R. ""BETO"" ALONZO",2,2,11,15
5,Railroad Commissioner,,DEM,CHRYSTA CASTANEDA,1,8,5,14
5,"CHIEF JUSTICE, SUPREME COURT",,DEM,JERRY ZIMMERER,3,8,28,39
5,"CHIEF JUSTICE, SUPREME COURT",,DEM,AMY CLARK MEACHUM,3,15,14,32
5,"JUSTICE, SUPREME COURT, PLACE 6",,DEM,KATHY CHENG,3,12,18,33
5,"JUSTICE, SUPREME COURT, PLACE 6",,DEM,LARRY PRAEGER,3,10,24,37
5,"JUSTICE, SUPREME COURT, PLACE 7",,DEM,STACI WILLIAMS,3,11,26,40
5,"JUSTICE, SUPREME COURT, PLACE 7",,DEM,BRANDY VOSS,3,11,14,28
5,"JUSTICE, SUPREME COURT, PLACE 8",,DEM,GISLA D. TRIANA,3,12,15,30
5,"JUSTICE, SUPREME COURT, PLACE 8",,DEM,PETER KELLY,3,11,27,41
5,"JUDGE, COURT OF CRIMINAL APPEALS, PL 3",,DEM,ELIZABETH DAVIS FRIZELL,4,11,20,35
5,"JUDGE, COURT OF CRIMINAL APPEALS, PL 3",,DEM,WILLIAM PIERATT DEMOND,0,4,4,8
5,"JUDGE, COURT OF CRIMINAL APPEALS, PL 3",,DEM,DAN WOOD,2,8,18,28
5,"JUDGE, COURT OF CRIMINAL APPEALS, PL 4",,DEM,TINA CLINTON,6,15,20,41
5,"JUDGE, COURT OF CRIMINAL APPEALS, PL 4",,DEM,STEVEN MIEARS,2,7,22,31
5,"JUDGE, COURT OF CRIMINAL APPEALS, PL 9",,DEM,BRANDON BIRMINGHAM,8,20,35,63
5,"MEMBER, STATE BOE, DISTRICT 1",,DEM,GEORGINA PEREZ,8,20,36,64
5,State Senate,19,DEM,FREDDY RAMIREZ,0,3,9,12
5,State Senate,19,DEM,ROLAND GUTIERREZ,6,14,20,40
5,State Senate,19,DEM,XOCHIL PENA RODRIGUEZ,2,5,11,18
5,State Representative,80,DEM,TRACY KING ,6,25,43,74
5,State Representative,80,DEM,DANNY VALDEZ,3,2,10,15
5,"CHIEF JUSTICE, 4TH COURT OF APPLEALS DIST",,DEM,REBECA MARTINEZ,8,23,36,67
6,President,,DEM,CORY BOOKER,0,0,0,0
6,President,,DEM,MICHAEL R. BLOOMBERG,0,5,6,11
6,President,,DEM,"ROQUE ""ROCKY"" DE LA FUENTE",0,2,0,2
6,President,,DEM,MICHAEL BENNET,0,0,0,0
6,President,,DEM,ROBBY WELLS,0,2,0,2
6,President,,DEM,TULSI GABBARD,0,0,2,2
6,President,,DEM,JOSEPH R. BIDEN,0,1,20,21
6,President,,DEM,ANDREW YANG,0,0,1,1
6,President,,DEM,JOHN K. DELANEY,0,2,0,2
6,President,,DEM,TOM STEYER,0,0,2,2
6,President,,DEM,DEVAL PATRICK,0,1,0,1
6,President,,DEM,PETE BUTTIGIEG,0,2,0,2
6,President,,DEM,ELIZABETH WARREN,0,2,2,4
6,President,,DEM,AMY KLOBUCHAR,2,0,2,4
6,President,,DEM,MARIANNE WILLIAMSON,0,0,0,0
6,President,,DEM,JULIAN CASTRO,0,3,5,8
6,President,,DEM,BERNIE SANDERS,1,6,13,20
6,U.S. Senate,,DEM,MICHAEL COPPER,0,6,6,12
6,U.S. Senate,,DEM,SEMA HERNANDEZ,0,5,7,12
6,U.S. Senate,,DEM,AMANDA K. EDWARDS,0,1,3,4
6,U.S. Senate,,DEM,"MARY ""MJ"" HEGAR",2,2,4,8
6,U.S. Senate,,DEM,CHRIS BELL,0,3,2,5
6,U.S. Senate,,DEM,ROYCE WEST,0,2,1,3
6,U.S. Senate,,DEM,ADRIAN OCEGUEDA,0,0,0,0
6,U.S. Senate,,DEM,"JACK DANIEL FOSTER, JR",0,0,1,1
6,U.S. Senate,,DEM,VICTOR HUGO HARRIS,0,0,3,3
6,U.S. Senate,,DEM,"ANNIE ""MAMA"" GARCIA",0,3,8,11
6,U.S. Senate,,DEM,D. R. HUNTER,0,0,1,1
6,U.S. Senate,,DEM,CRISTINA TZINTZUN RAMIREZ,0,2,16,18
6,U.S. House,23,DEM,JAMIE ESCUDER,0,1,2,3
6,U.S. House,23,DEM,EFRAIN V. VALDEZ,0,2,4,6
6,U.S. House,23,DEM,GINA ORTIZ JONES,1,18,40,59
6,U.S. House,23,DEM,RICARDO R. MADRID,2,3,6,11
6,U.S. House,23,DEM,"ROSALINA ""ROSEY"" RAMOS ABUABARA",0,4,2,6
6,Railroad Commissioner,,DEM,MARK WATSON ,0,6,16,22
6,Railroad Commissioner,,DEM,KELLEY STONE,2,3,7,12
6,Railroad Commissioner,,DEM,"ROBERTO R. ""BETO"" ALONZO",0,9,20,29
6,Railroad Commissioner,,DEM,CHRYSTA CASTANEDA,0,4,12,16
6,"CHIEF JUSTICE, SUPREME COURT",,DEM,JERRY ZIMMERER,0,12,15,27
6,"CHIEF JUSTICE, SUPREME COURT",,DEM,AMY CLARK MEACHUM,2,10,32,44
6,"JUSTICE, SUPREME COURT, PLACE 6",,DEM,KATHY CHENG,0,7,34,41
6,"JUSTICE, SUPREME COURT, PLACE 6",,DEM,LARRY PRAEGER,2,13,17,32
6,"JUSTICE, SUPREME COURT, PLACE 7",,DEM,STACI WILLIAMS,0,14,27,41
6,"JUSTICE, SUPREME COURT, PLACE 7",,DEM,BRANDY VOSS,2,7,23,32
6,"JUSTICE, SUPREME COURT, PLACE 8",,DEM,GISLA D. TRIANA,0,10,31,41
6,"JUSTICE, SUPREME COURT, PLACE 8",,DEM,PETER KELLY,2,12,18,32
6,"JUDGE, COURT OF CRIMINAL APPEALS, PL 3",,DEM,ELIZABETH DAVIS FRIZELL,2,11,29,42
6,"JUDGE, COURT OF CRIMINAL APPEALS, PL 3",,DEM,WILLIAM PIERATT DEMOND,0,2,2,4
6,"JUDGE, COURT OF CRIMINAL APPEALS, PL 3",,DEM,DAN WOOD,0,9,18,27
6,"JUDGE, COURT OF CRIMINAL APPEALS, PL 4",,DEM,TINA CLINTON,2,16,36,54
6,"JUDGE, COURT OF CRIMINAL APPEALS, PL 4",,DEM,STEVEN MIEARS,0,8,16,24
6,"JUDGE, COURT OF CRIMINAL APPEALS, PL 9",,DEM,BRANDON BIRMINGHAM,2,18,39,59
6,"MEMBER, STATE BOE, DISTRICT 1",,DEM,GEORGINA PEREZ,2,18,39,59
6,State Senate,19,DEM,FREDDY RAMIREZ,2,3,11,16
6,State Senate,19,DEM,ROLAND GUTIERREZ,0,15,21,36
6,State Senate,19,DEM,XOCHIL PENA RODRIGUEZ,0,6,17,23
6,State Representative,80,DEM,TRACY KING ,3,21,42,66
6,State Representative,80,DEM,DANNY VALDEZ,0,9,14,23
6,"CHIEF JUSTICE, 4TH COURT OF APPLEALS DIST",,DEM,REBECA MARTINEZ,2,19,44,65
8,President,,DEM,CORY BOOKER,1,1,2,4
8,President,,DEM,MICHAEL R. BLOOMBERG,16,29,37,82
8,President,,DEM,"ROQUE ""ROCKY"" DE LA FUENTE",0,4,1,5
8,President,,DEM,MICHAEL BENNET,0,2,2,4
8,President,,DEM,ROBBY WELLS,0,0,1,1
8,President,,DEM,TULSI GABBARD,0,1,1,2
8,President,,DEM,JOSEPH R. BIDEN,13,16,51,80
8,President,,DEM,ANDREW YANG,0,5,0,5
8,President,,DEM,JOHN K. DELANEY,0,1,1,2
8,President,,DEM,TOM STEYER,1,2,1,4
8,President,,DEM,DEVAL PATRICK,0,0,0,0
8,President,,DEM,PETE BUTTIGIEG,3,1,1,5
8,President,,DEM,ELIZABETH WARREN,0,17,6,23
8,President,,DEM,AMY KLOBUCHAR,0,9,1,10
8,President,,DEM,MARIANNE WILLIAMSON,0,0,0,0
8,President,,DEM,JULIAN CASTRO,5,18,16,39
8,President,,DEM,BERNIE SANDERS,17,46,48,111
8,U.S. Senate,,DEM,MICHAEL COPPER,2,14,10,26
8,U.S. Senate,,DEM,SEMA HERNANDEZ,7,26,25,58
8,U.S. Senate,,DEM,AMANDA K. EDWARDS,2,4,7,13
8,U.S. Senate,,DEM,"MARY ""MJ"" HEGAR",8,13,8,29
8,U.S. Senate,,DEM,CHRIS BELL,2,9,9,20
8,U.S. Senate,,DEM,ROYCE WEST,0,6,3,9
8,U.S. Senate,,DEM,ADRIAN OCEGUEDA,2,5,4,11
8,U.S. Senate,,DEM,"JACK DANIEL FOSTER, JR",0,5,6,11
8,U.S. Senate,,DEM,VICTOR HUGO HARRIS,1,1,5,7
8,U.S. Senate,,DEM,"ANNIE ""MAMA"" GARCIA",5,24,24,53
8,U.S. Senate,,DEM,D. R. HUNTER,0,0,2,2
8,U.S. Senate,,DEM,CRISTINA TZINTZUN RAMIREZ,9,24,48,81
8,U.S. House,23,DEM,JAMIE ESCUDER,3,7,4,14
8,U.S. House,23,DEM,EFRAIN V. VALDEZ,5,19,31,55
8,U.S. House,23,DEM,GINA ORTIZ JONES,33,96,97,226
8,U.S. House,23,DEM,RICARDO R. MADRID,2,10,7,19
8,U.S. House,23,DEM,"ROSALINA ""ROSEY"" RAMOS ABUABARA",4,17,16,37
8,Railroad Commissioner,,DEM,MARK WATSON ,9,23,23,55
8,Railroad Commissioner,,DEM,KELLEY STONE,2,19,26,47
8,Railroad Commissioner,,DEM,"ROBERTO R. ""BETO"" ALONZO",19,63,78,160
8,Railroad Commissioner,,DEM,CHRYSTA CASTANEDA,8,23,21,52
8,"CHIEF JUSTICE, SUPREME COURT",,DEM,JERRY ZIMMERER,16,70,63,149
8,"CHIEF JUSTICE, SUPREME COURT",,DEM,AMY CLARK MEACHUM,16,48,67,131
8,"JUSTICE, SUPREME COURT, PLACE 6",,DEM,KATHY CHENG,19,80,75,174
8,"JUSTICE, SUPREME COURT, PLACE 6",,DEM,LARRY PRAEGER,18,40,54,112
8,"JUSTICE, SUPREME COURT, PLACE 7",,DEM,STACI WILLIAMS,23,75,93,191
8,"JUSTICE, SUPREME COURT, PLACE 7",,DEM,BRANDY VOSS,11,41,35,87
8,"JUSTICE, SUPREME COURT, PLACE 8",,DEM,GISLA D. TRIANA,28,78,83,189
8,"JUSTICE, SUPREME COURT, PLACE 8",,DEM,PETER KELLY,11,40,51,102
8,"JUDGE, COURT OF CRIMINAL APPEALS, PL 3",,DEM,ELIZABETH DAVIS FRIZELL,22,67,72,161
8,"JUDGE, COURT OF CRIMINAL APPEALS, PL 3",,DEM,WILLIAM PIERATT DEMOND,8,17,27,52
8,"JUDGE, COURT OF CRIMINAL APPEALS, PL 3",,DEM,DAN WOOD,6,37,37,80
8,"JUDGE, COURT OF CRIMINAL APPEALS, PL 4",,DEM,TINA CLINTON,26,88,104,218
8,"JUDGE, COURT OF CRIMINAL APPEALS, PL 4",,DEM,STEVEN MIEARS,12,35,31,78
8,"JUDGE, COURT OF CRIMINAL APPEALS, PL 9",,DEM,BRANDON BIRMINGHAM,27,91,102,220
8,"MEMBER, STATE BOE, DISTRICT 1",,DEM,GEORGINA PEREZ,28,92,106,226
8,State Senate,19,DEM,FREDDY RAMIREZ,4,28,28,60
8,State Senate,19,DEM,ROLAND GUTIERREZ,30,66,74,170
8,State Senate,19,DEM,XOCHIL PENA RODRIGUEZ,15,42,51,108
8,State Representative,80,DEM,TRACY KING ,45,131,136,312
8,State Representative,80,DEM,DANNY VALDEZ,18,42,48,108
8,"CHIEF JUSTICE, 4TH COURT OF APPLEALS DIST",,DEM,REBECA MARTINEZ,29,93,106,228
9,President,,DEM,CORY BOOKER,0,1,0,1
9,President,,DEM,MICHAEL R. BLOOMBERG,10,10,33,53
9,President,,DEM,"ROQUE ""ROCKY"" DE LA FUENTE",0,4,0,4
9,President,,DEM,MICHAEL BENNET,0,0,0,0
9,President,,DEM,ROBBY WELLS,0,1,0,1
9,President,,DEM,TULSI GABBARD,0,0,1,1
9,President,,DEM,JOSEPH R. BIDEN,11,8,48,67
9,President,,DEM,ANDREW YANG,0,1,2,3
9,President,,DEM,JOHN K. DELANEY,0,0,1,1
9,President,,DEM,TOM STEYER,0,0,4,4
9,President,,DEM,DEVAL PATRICK,0,0,0,0
9,President,,DEM,PETE BUTTIGIEG,0,0,1,1
9,President,,DEM,ELIZABETH WARREN,0,3,11,14
9,President,,DEM,AMY KLOBUCHAR,1,3,2,6
9,President,,DEM,MARIANNE WILLIAMSON,0,0,1,1
9,President,,DEM,JULIAN CASTRO,3,11,18,32
9,President,,DEM,BERNIE SANDERS,20,16,50,86
9,U.S. Senate,,DEM,MICHAEL COPPER,0,4,9,13
9,U.S. Senate,,DEM,SEMA HERNANDEZ,4,10,19,33
9,U.S. Senate,,DEM,AMANDA K. EDWARDS,2,3,5,10
9,U.S. Senate,,DEM,"MARY ""MJ"" HEGAR",4,3,10,17
9,U.S. Senate,,DEM,CHRIS BELL,0,2,8,10
9,U.S. Senate,,DEM,ROYCE WEST,2,0,2,4
9,U.S. Senate,,DEM,ADRIAN OCEGUEDA,2,2,5,9
9,U.S. Senate,,DEM,"JACK DANIEL FOSTER, JR",1,4,5,10
9,U.S. Senate,,DEM,VICTOR HUGO HARRIS,0,0,3,3
9,U.S. Senate,,DEM,"ANNIE ""MAMA"" GARCIA",3,10,21,34
9,U.S. Senate,,DEM,D. R. HUNTER,0,0,3,3
9,U.S. Senate,,DEM,CRISTINA TZINTZUN RAMIREZ,12,15,46,73
9,U.S. House,23,DEM,JAMIE ESCUDER,0,4,5,9
9,U.S. House,23,DEM,EFRAIN V. VALDEZ,0,12,33,45
9,U.S. House,23,DEM,GINA ORTIZ JONES,38,32,91,161
9,U.S. House,23,DEM,RICARDO R. MADRID,0,3,8,11
9,U.S. House,23,DEM,"ROSALINA ""ROSEY"" RAMOS ABUABARA",1,6,17,24
9,Railroad Commissioner,,DEM,MARK WATSON ,1,6,14,21
9,Railroad Commissioner,,DEM,KELLEY STONE,4,4,26,34
9,Railroad Commissioner,,DEM,"ROBERTO R. ""BETO"" ALONZO",18,32,80,130
9,Railroad Commissioner,,DEM,CHRYSTA CASTANEDA,5,9,21,35
9,"CHIEF JUSTICE, SUPREME COURT",,DEM,JERRY ZIMMERER,9,22,59,90
9,"CHIEF JUSTICE, SUPREME COURT",,DEM,AMY CLARK MEACHUM,18,27,61,106
9,"JUSTICE, SUPREME COURT, PLACE 6",,DEM,KATHY CHENG,17,32,74,123
9,"JUSTICE, SUPREME COURT, PLACE 6",,DEM,LARRY PRAEGER,8,15,46,69
9,"JUSTICE, SUPREME COURT, PLACE 7",,DEM,STACI WILLIAMS,19,35,90,144
9,"JUSTICE, SUPREME COURT, PLACE 7",,DEM,BRANDY VOSS,3,14,30,47
9,"JUSTICE, SUPREME COURT, PLACE 8",,DEM,GISLA D. TRIANA,15,36,81,132
9,"JUSTICE, SUPREME COURT, PLACE 8",,DEM,PETER KELLY,7,12,37,56
9,"JUDGE, COURT OF CRIMINAL APPEALS, PL 3",,DEM,ELIZABETH DAVIS FRIZELL,18,31,68,117
9,"JUDGE, COURT OF CRIMINAL APPEALS, PL 3",,DEM,WILLIAM PIERATT DEMOND,2,2,26,30
9,"JUDGE, COURT OF CRIMINAL APPEALS, PL 3",,DEM,DAN WOOD,3,12,29,44
9,"JUDGE, COURT OF CRIMINAL APPEALS, PL 4",,DEM,TINA CLINTON,19,37,84,140
9,"JUDGE, COURT OF CRIMINAL APPEALS, PL 4",,DEM,STEVEN MIEARS,2,16,41,59
9,"JUDGE, COURT OF CRIMINAL APPEALS, PL 9",,DEM,BRANDON BIRMINGHAM,20,38,93,151
9,"MEMBER, STATE BOE, DISTRICT 1",,DEM,GEORGINA PEREZ,24,38,99,161
9,State Senate,19,DEM,FREDDY RAMIREZ,3,14,35,52
9,State Senate,19,DEM,ROLAND GUTIERREZ,13,26,74,113
9,State Senate,19,DEM,XOCHIL PENA RODRIGUEZ,13,15,34,62
9,State Representative,80,DEM,TRACY KING ,43,54,116,213
9,State Representative,80,DEM,DANNY VALDEZ,11,25,76,112
9,"CHIEF JUSTICE, 4TH COURT OF APPLEALS DIST",,DEM,REBECA MARTINEZ,25,40,110,175
10,President,,DEM,CORY BOOKER,0,1,3,4
10,President,,DEM,MICHAEL R. BLOOMBERG,7,8,24,39
10,President,,DEM,"ROQUE ""ROCKY"" DE LA FUENTE",0,0,1,1
10,President,,DEM,MICHAEL BENNET,0,0,2,2
10,President,,DEM,ROBBY WELLS,0,0,1,1
10,President,,DEM,TULSI GABBARD,0,5,1,6
10,President,,DEM,JOSEPH R. BIDEN,3,4,35,42
10,President,,DEM,ANDREW YANG,0,1,0,1
10,President,,DEM,JOHN K. DELANEY,0,0,1,1
10,President,,DEM,TOM STEYER,0,0,10,10
10,President,,DEM,DEVAL PATRICK,1,0,0,1
10,President,,DEM,PETE BUTTIGIEG,1,0,2,3
10,President,,DEM,ELIZABETH WARREN,0,4,15,19
10,President,,DEM,AMY KLOBUCHAR,1,6,5,12
10,President,,DEM,MARIANNE WILLIAMSON,1,1,0,2
10,President,,DEM,JULIAN CASTRO,2,8,13,23
10,President,,DEM,BERNIE SANDERS,4,11,33,48
10,U.S. Senate,,DEM,MICHAEL COPPER,2,6,10,18
10,U.S. Senate,,DEM,SEMA HERNANDEZ,2,5,11,18
10,U.S. Senate,,DEM,AMANDA K. EDWARDS,2,1,5,8
10,U.S. Senate,,DEM,"MARY ""MJ"" HEGAR",2,3,13,18
10,U.S. Senate,,DEM,CHRIS BELL,0,4,12,16
10,U.S. Senate,,DEM,ROYCE WEST,0,4,8,12
10,U.S. Senate,,DEM,ADRIAN OCEGUEDA,2,0,2,4
10,U.S. Senate,,DEM,"JACK DANIEL FOSTER, JR",1,4,7,12
10,U.S. Senate,,DEM,VICTOR HUGO HARRIS,0,0,2,2
10,U.S. Senate,,DEM,"ANNIE ""MAMA"" GARCIA",2,5,21,28
10,U.S. Senate,,DEM,D. R. HUNTER,0,3,6,9
10,U.S. Senate,,DEM,CRISTINA TZINTZUN RAMIREZ,3,5,24,32
10,U.S. House,23,DEM,JAMIE ESCUDER,2,3,8,13
10,U.S. House,23,DEM,EFRAIN V. VALDEZ,2,10,25,37
10,U.S. House,23,DEM,GINA ORTIZ JONES,15,20,71,106
10,U.S. House,23,DEM,RICARDO R. MADRID,0,4,13,17
10,U.S. House,23,DEM,"ROSALINA ""ROSEY"" RAMOS ABUABARA",1,6,14,21
10,Railroad Commissioner,,DEM,MARK WATSON ,2,13,31,46
10,Railroad Commissioner,,DEM,KELLEY STONE,3,6,24,33
10,Railroad Commissioner,,DEM,"ROBERTO R. ""BETO"" ALONZO",9,12,48,69
10,Railroad Commissioner,,DEM,CHRYSTA CASTANEDA,3,10,25,38
10,"CHIEF JUSTICE, SUPREME COURT",,DEM,JERRY ZIMMERER,8,17,55,80
10,"CHIEF JUSTICE, SUPREME COURT",,DEM,AMY CLARK MEACHUM,5,18,60,83
10,"JUSTICE, SUPREME COURT, PLACE 6",,DEM,KATHY CHENG,8,17,58,83
10,"JUSTICE, SUPREME COURT, PLACE 6",,DEM,LARRY PRAEGER,6,18,54,78
10,"JUSTICE, SUPREME COURT, PLACE 7",,DEM,STACI WILLIAMS,10,29,75,114
10,"JUSTICE, SUPREME COURT, PLACE 7",,DEM,BRANDY VOSS,5,8,35,48
10,"JUSTICE, SUPREME COURT, PLACE 8",,DEM,GISLA D. TRIANA,8,31,54,93
10,"JUSTICE, SUPREME COURT, PLACE 8",,DEM,PETER KELLY,8,16,57,81
10,"JUDGE, COURT OF CRIMINAL APPEALS, PL 3",,DEM,ELIZABETH DAVIS FRIZELL,8,17,55,80
10,"JUDGE, COURT OF CRIMINAL APPEALS, PL 3",,DEM,WILLIAM PIERATT DEMOND,0,6,15,21
10,"JUDGE, COURT OF CRIMINAL APPEALS, PL 3",,DEM,DAN WOOD,8,13,44,65
10,"JUDGE, COURT OF CRIMINAL APPEALS, PL 4",,DEM,TINA CLINTON,20,22,66,108
10,"JUDGE, COURT OF CRIMINAL APPEALS, PL 4",,DEM,STEVEN MIEARS,6,8,47,61
10,"JUDGE, COURT OF CRIMINAL APPEALS, PL 9",,DEM,BRANDON BIRMINGHAM,15,26,88,129
10,"MEMBER, STATE BOE, DISTRICT 1",,DEM,GEORGINA PEREZ,15,25,86,126
10,State Senate,19,DEM,FREDDY RAMIREZ,1,13,40,54
10,State Senate,19,DEM,ROLAND GUTIERREZ,10,16,47,73
10,State Senate,19,DEM,XOCHIL PENA RODRIGUEZ,5,10,29,44
10,State Representative,80,DEM,TRACY KING ,22,48,146,216
10,State Representative,80,DEM,DANNY VALDEZ,7,19,38,64
10,"CHIEF JUSTICE, 4TH COURT OF APPLEALS DIST",,DEM,REBECA MARTINEZ,17,30,93,140
1,President,,REP,BILL WELD,0,0,0,0
1,President,,REP,BOB ELY,0,0,0,0
1,President,,REP,DONALD J. TRUMP,0,18,19,37
1,President,,REP,JOE WALSH,0,0,0,0
1,President,,REP,MATTHEW JOHN MATERN,0,0,1,1
1,President,,REP,"ROQUE ""ROCKY"" DE LA FUENTE GUERRA",1,1,0,2
1,President,,REP,UNCOMMITTED,0,1,0,1
1,President,,REP,ZOLTAN G. ISTVAN,0,0,0,0
1,JUSTICE SUPREME COURT PLACE 8,,REP,BRETT BUSBY,0,13,11,24
1,JUSTICE SUPREME COURT PLACE 6,,REP,JANE BLAND,0,13,13,26
1,JUSTICE SUPREME COURT PLACE 7,,REP,JEFF BOYD,0,15,12,27
1,"JUDGE,COURT OF CRIMINAL APPLEALS PLACE 4",,REP,KEVINE PATRICK YEARLY,0,14,11,25
1,"JUDGE,COURT OF CRIMINAL APPLEALS PLACE 3",,REP,BERT RICHARDSON,0,11,11,22
1,"JUDGE,COURT OF CRIMINAL APPLEALS PLACE 3",,REP,GINA PARKER,0,5,6,11
1,"JUDGE, COURT OF CRIMINAL APPLEALS PLACE 9",,REP,DAVID NEWELL,0,14,11,25
1,"DISTRICT ATTORNEY, 81ST JUDICIAL DISTRICT",,REP,AUDREY GOSSETT LOUIS,0,14,13,27
1,U.S. Senate,,REP,DWAYNE STOVALL,0,2,1,3
1,U.S. Senate,,REP,JOHN ANTHONY CASTRO,0,2,2,4
1,U.S. Senate,,REP,JOHN CORNYN,0,10,13,23
1,U.S. Senate,,REP,MARKY YANCEY,0,2,0,2
1,U.S. Senate,23,REP,VIRGIL BIERSCHWALE,0,0,1,1
1,U.S. House,23,REP,ALMA ARREDONDO-LYNCH,0,3,6,9
1,U.S. House,23,REP,ALIA URESTE,0,1,2,3
1,U.S. House,23,REP,BEN VAN WINKLE,0,1,0,1
1,U.S. House,23,REP,"CECIL B. ""BURT"" JONES",0,0,0,0
1,U.S. House,23,REP,DARWEN BOEDEKER,0,0,0,0
1,U.S. House,23,REP,JEFF MCFARLIN,0,1,2,3
1,U.S. House,23,REP,RAUL REYES,0,2,0,2
1,U.S. House,23,REP,SHARON BRECKENBRIDGE THOMAS,0,1,1,2
1,U.S. House,,REP,TONY GONZALES,0,7,6,13
1,"CHIEF JUSTICE, SUPREME COURT",,REP,NATHAN HECHT,0,14,13,27
1,Railroad Commissioner,,REP,"JAMES ""JIM"" WRIGHT",1,9,7,17
1,Railroad Commissioner,19,REP,RYAN SITTON,0,7,9,16
1,State Senate,,REP,"PETER P. ""PETE"" FLORES",0,13,10,23
1,"CHIEF JUSTICE, 4TH COURT OF APPEALS DISTRICT",,REP,RENEE YANTA,0,14,11,25
1,"MEMBER, STATE BOARD OF EDUCATION, DISTRICT 1",,REP,JENNIFER IVEY,0,14,11,25
1,REP. SHERIFF,,REP,"RAY TALAMANTES,SR",0,3,7,10
1,REP. SHERIFF,,REP,RICHARD GANDARA,0,17,15,32
2,President,,REP,BILL WELD,0,0,0,0
2,President,,REP,BOB ELY,0,0,0,0
2,President,,REP,DONALD J. TRUMP,0,5,2,7
2,President,,REP,JOE WALSH,0,0,0,0
2,President,,REP,MATTHEW JOHN MATERN,0,0,0,0
2,President,,REP,"ROQUE ""ROCKY"" DE LA FUENTE GUERRA",0,1,0,1
2,President,,REP,UNCOMMITTED,0,3,1,4
2,President,,REP,ZOLTAN G. ISTVAN,0,0,0,0
2,JUSTICE SUPREME COURT PLACE 8,,REP,BRETT BUSBY,0,5,0,5
2,JUSTICE SUPREME COURT PLACE 6,,REP,JANE BLAND,0,5,0,5
2,JUSTICE SUPREME COURT PLACE 7,,REP,JEFF BOYD,0,6,0,6
2,"JUDGE,COURT OF CRIMINAL APPLEALS PLACE 4",,REP,KEVINE PATRICK YEARLY,0,6,0,6
2,"JUDGE,COURT OF CRIMINAL APPLEALS PLACE 3",,REP,BERT RICHARDSON,0,3,1,4
2,"JUDGE,COURT OF CRIMINAL APPLEALS PLACE 3",,REP,GINA PARKER,0,4,1,5
2,"JUDGE, COURT OF CRIMINAL APPLEALS PLACE 9",,REP,DAVID NEWELL,0,6,0,6
2,"DISTRICT ATTORNEY, 81ST JUDICIAL DISTRICT",,REP,AUDREY GOSSETT LOUIS,0,6,1,7
2,U.S. Senate,,REP,DWAYNE STOVALL,0,2,0,2
2,U.S. Senate,,REP,JOHN ANTHONY CASTRO,0,2,1,3
2,U.S. Senate,,REP,JOHN CORNYN,0,4,1,5
2,U.S. Senate,,REP,MARKY YANCEY,0,1,0,1
2,U.S. Senate,23,REP,VIRGIL BIERSCHWALE,0,0,1,1
2,U.S. House,23,REP,ALMA ARREDONDO-LYNCH,0,2,0,2
2,U.S. House,23,REP,ALIA URESTE,0,1,0,1
2,U.S. House,23,REP,BEN VAN WINKLE,0,0,0,0
2,U.S. House,23,REP,"CECIL B. ""BURT"" JONES",0,1,0,1
2,U.S. House,23,REP,DARWEN BOEDEKER,0,0,0,0
2,U.S. House,23,REP,JEFF MCFARLIN,0,0,0,0
2,U.S. House,23,REP,RAUL REYES,0,0,0,0
2,U.S. House,23,REP,SHARON BRECKENBRIDGE THOMAS,0,1,0,1
2,U.S. House,,REP,TONY GONZALES,0,3,2,5
2,"CHIEF JUSTICE, SUPREME COURT",,REP,NATHAN HECHT,0,5,0,5
2,Railroad Commissioner,,REP,"JAMES ""JIM"" WRIGHT",0,3,1,4
2,Railroad Commissioner,19,REP,RYAN SITTON,0,4,1,5
2,State Senate,,REP,"PETER P. ""PETE"" FLORES",0,6,0,6
2,"CHIEF JUSTICE, 4TH COURT OF APPEALS DISTRICT",,REP,RENEE YANTA,0,5,0,5
2,"MEMBER, STATE BOARD OF EDUCATION, DISTRICT 1",,REP,JENNIFER IVEY,0,6,0,6
2,REP. SHERIFF,,REP,"RAY TALAMANTES,SR",0,4,1,5
2,REP. SHERIFF,,REP,RICHARD GANDARA,0,6,1,7
3,President,,REP,BILL WELD,0,0,0,0
3,President,,REP,BOB ELY,0,0,0,0
3,President,,REP,DONALD J. TRUMP,0,5,9,14
3,President,,REP,JOE WALSH,0,0,0,0
3,President,,REP,MATTHEW JOHN MATERN,0,0,0,0
3,President,,REP,"ROQUE ""ROCKY"" DE LA FUENTE GUERRA",0,0,0,0
3,President,,REP,UNCOMMITTED,0,0,0,0
3,President,,REP,ZOLTAN G. ISTVAN,0,0,0,0
3,JUSTICE SUPREME COURT PLACE 8,,REP,BRETT BUSBY,0,3,6,9
3,JUSTICE SUPREME COURT PLACE 6,,REP,JANE BLAND,0,3,6,9
3,JUSTICE SUPREME COURT PLACE 7,,REP,JEFF BOYD,0,3,6,9
3,"JUDGE,COURT OF CRIMINAL APPLEALS PLACE 4",,REP,KEVINE PATRICK YEARLY,0,3,6,9
3,"JUDGE,COURT OF CRIMINAL APPLEALS PLACE 3",,REP,BERT RICHARDSON,0,2,6,8
3,"JUDGE,COURT OF CRIMINAL APPLEALS PLACE 3",,REP,GINA PARKER,0,1,3,4
3,"JUDGE, COURT OF CRIMINAL APPLEALS PLACE 9",,REP,DAVID NEWELL,0,3,6,9
3,"DISTRICT ATTORNEY, 81ST JUDICIAL DISTRICT",,REP,AUDREY GOSSETT LOUIS,0,3,5,8
3,U.S. Senate,,REP,DWAYNE STOVALL,0,1,1,2
3,U.S. Senate,,REP,JOHN ANTHONY CASTRO,0,1,1,2
3,U.S. Senate,,REP,JOHN CORNYN,0,1,6,7
3,U.S. Senate,,REP,MARKY YANCEY,0,0,0,0
3,U.S. Senate,23,REP,VIRGIL BIERSCHWALE,0,0,0,0
3,U.S. House,23,REP,ALMA ARREDONDO-LYNCH,0,1,0,1
3,U.S. House,23,REP,ALIA URESTE,0,0,2,2
3,U.S. House,23,REP,BEN VAN WINKLE,0,0,0,0
3,U.S. House,23,REP,"CECIL B. ""BURT"" JONES",0,0,1,1
3,U.S. House,23,REP,DARWEN BOEDEKER,0,1,0,1
3,U.S. House,23,REP,JEFF MCFARLIN,0,1,0,1
3,U.S. House,23,REP,RAUL REYES,0,0,3,3
3,U.S. House,23,REP,SHARON BRECKENBRIDGE THOMAS,0,0,1,1
3,U.S. House,,REP,TONY GONZALES,0,0,1,1
3,"CHIEF JUSTICE, SUPREME COURT",,REP,NATHAN HECHT,0,3,6,9
3,Railroad Commissioner,,REP,"JAMES ""JIM"" WRIGHT",0,1,5,6
3,Railroad Commissioner,19,REP,RYAN SITTON,0,2,3,5
3,State Senate,,REP,"PETER P. ""PETE"" FLORES",0,4,8,12
3,"CHIEF JUSTICE, 4TH COURT OF APPEALS DISTRICT",,REP,RENEE YANTA,0,3,5,8
3,"MEMBER, STATE BOARD OF EDUCATION, DISTRICT 1",,REP,JENNIFER IVEY,0,3,6,9
3,REP. SHERIFF,,REP,"RAY TALAMANTES,SR",0,2,1,3
3,REP. SHERIFF,,REP,RICHARD GANDARA,0,3,6,9
4,President,,REP,BILL WELD,0,0,1,1
4,President,,REP,BOB ELY,0,0,1,1
4,President,,REP,DONALD J. TRUMP,3,30,36,69
4,President,,REP,JOE WALSH,0,0,0,0
4,President,,REP,MATTHEW JOHN MATERN,0,0,0,0
4,President,,REP,"ROQUE ""ROCKY"" DE LA FUENTE GUERRA",0,1,1,2
4,President,,REP,UNCOMMITTED,0,1,1,2
4,President,,REP,ZOLTAN G. ISTVAN,0,0,0,0
4,JUSTICE SUPREME COURT PLACE 8,,REP,BRETT BUSBY,3,22,33,58
4,JUSTICE SUPREME COURT PLACE 6,,REP,JANE BLAND,3,22,35,60
4,JUSTICE SUPREME COURT PLACE 7,,REP,JEFF BOYD,3,22,34,59
4,"JUDGE,COURT OF CRIMINAL APPLEALS PLACE 4",,REP,KEVINE PATRICK YEARLY,3,21,34,58
4,"JUDGE,COURT OF CRIMINAL APPLEALS PLACE 3",,REP,BERT RICHARDSON,2,16,20,38
4,"JUDGE,COURT OF CRIMINAL APPLEALS PLACE 3",,REP,GINA PARKER,0,7,16,23
4,"JUDGE, COURT OF CRIMINAL APPLEALS PLACE 9",,REP,DAVID NEWELL,3,21,33,57
4,"DISTRICT ATTORNEY, 81ST JUDICIAL DISTRICT",,REP,AUDREY GOSSETT LOUIS,3,22,32,57
4,U.S. Senate,,REP,DWAYNE STOVALL,0,2,7,9
4,U.S. Senate,,REP,JOHN ANTHONY CASTRO,0,3,7,10
4,U.S. Senate,,REP,JOHN CORNYN,3,19,19,41
4,U.S. Senate,,REP,MARKY YANCEY,0,2,3,5
4,U.S. Senate,23,REP,VIRGIL BIERSCHWALE,0,0,0,0
4,U.S. House,23,REP,ALMA ARREDONDO-LYNCH,0,4,4,8
4,U.S. House,23,REP,ALIA URESTE,0,0,0,0
4,U.S. House,23,REP,BEN VAN WINKLE,0,2,5,7
4,U.S. House,23,REP,"CECIL B. ""BURT"" JONES",0,2,4,6
4,U.S. House,23,REP,DARWEN BOEDEKER,0,0,1,1
4,U.S. House,23,REP,JEFF MCFARLIN,0,5,7,12
4,U.S. House,23,REP,RAUL REYES,1,1,4,6
4,U.S. House,23,REP,SHARON BRECKENBRIDGE THOMAS,0,2,2,4
4,U.S. House,,REP,TONY GONZALES,2,7,9,18
4,"CHIEF JUSTICE, SUPREME COURT",,REP,NATHAN HECHT,3,22,35,60
4,Railroad Commissioner,,REP,"JAMES ""JIM"" WRIGHT",0,15,26,41
4,Railroad Commissioner,19,REP,RYAN SITTON,3,7,11,21
4,State Senate,,REP,"PETER P. ""PETE"" FLORES",3,22,33,58
4,"CHIEF JUSTICE, 4TH COURT OF APPEALS DISTRICT",,REP,RENEE YANTA,3,20,33,56
4,"MEMBER, STATE BOARD OF EDUCATION, DISTRICT 1",,REP,JENNIFER IVEY,3,21,33,57
4,REP. SHERIFF,,REP,"RAY TALAMANTES,SR",0,15,17,32
4,REP. SHERIFF,,REP,RICHARD GANDARA,1,14,18,33
5,President,,REP,BILL WELD,0,0,0,0
5,President,,REP,BOB ELY,0,0,0,0
5,President,,REP,DONALD J. TRUMP,0,20,57,77
5,President,,REP,JOE WALSH,0,0,0,0
5,President,,REP,MATTHEW JOHN MATERN,0,0,0,0
5,President,,REP,"ROQUE ""ROCKY"" DE LA FUENTE GUERRA",0,0,0,0
5,President,,REP,UNCOMMITTED,0,0,0,0
5,President,,REP,ZOLTAN G. ISTVAN,0,0,0,0
5,JUSTICE SUPREME COURT PLACE 8,,REP,BRETT BUSBY,0,17,46,63
5,JUSTICE SUPREME COURT PLACE 6,,REP,JANE BLAND,0,17,47,64
5,JUSTICE SUPREME COURT PLACE 7,,REP,JEFF BOYD,0,17,46,63
5,"JUDGE,COURT OF CRIMINAL APPLEALS PLACE 4",,REP,KEVINE PATRICK YEARLY,0,17,47,64
5,"JUDGE,COURT OF CRIMINAL APPLEALS PLACE 3",,REP,BERT RICHARDSON,0,10,36,46
5,"JUDGE,COURT OF CRIMINAL APPLEALS PLACE 3",,REP,GINA PARKER,0,10,13,23
5,"JUDGE, COURT OF CRIMINAL APPLEALS PLACE 9",,REP,DAVID NEWELL,0,17,47,64
5,"DISTRICT ATTORNEY, 81ST JUDICIAL DISTRICT",,REP,AUDREY GOSSETT LOUIS,0,18,48,66
5,U.S. Senate,,REP,DWAYNE STOVALL,0,2,4,6
5,U.S. Senate,,REP,JOHN ANTHONY CASTRO,0,0,3,3
5,U.S. Senate,,REP,JOHN CORNYN,0,18,40,58
5,U.S. Senate,,REP,MARKY YANCEY,0,0,3,3
5,U.S. Senate,23,REP,VIRGIL BIERSCHWALE,0,0,3,3
5,U.S. House,23,REP,ALMA ARREDONDO-LYNCH,0,3,10,13
5,U.S. House,23,REP,ALIA URESTE,0,0,0,0
5,U.S. House,23,REP,BEN VAN WINKLE,0,1,5,6
5,U.S. House,23,REP,"CECIL B. ""BURT"" JONES",0,0,2,2
5,U.S. House,23,REP,DARWEN BOEDEKER,0,0,2,2
5,U.S. House,23,REP,JEFF MCFARLIN,0,3,3,6
5,U.S. House,23,REP,RAUL REYES,0,8,18,26
5,U.S. House,23,REP,SHARON BRECKENBRIDGE THOMAS,0,1,1,2
5,U.S. House,,REP,TONY GONZALES,0,4,13,17
5,"CHIEF JUSTICE, SUPREME COURT",,REP,NATHAN HECHT,0,17,47,64
5,Railroad Commissioner,,REP,"JAMES ""JIM"" WRIGHT",0,13,31,44
5,Railroad Commissioner,19,REP,RYAN SITTON,0,5,21,26
5,State Senate,,REP,"PETER P. ""PETE"" FLORES",0,18,48,66
5,"CHIEF JUSTICE, 4TH COURT OF APPEALS DISTRICT",,REP,RENEE YANTA,0,16,47,63
5,"MEMBER, STATE BOARD OF EDUCATION, DISTRICT 1",,REP,JENNIFER IVEY,0,17,47,64
5,REP. SHERIFF,,REP,"RAY TALAMANTES,SR",0,8,36,44
5,REP. SHERIFF,,REP,RICHARD GANDARA,0,10,15,25
6,President,,REP,BILL WELD,0,0,0,0
6,President,,REP,BOB ELY,0,0,0,0
6,President,,REP,DONALD J. TRUMP,3,27,56,86
6,President,,REP,JOE WALSH,0,0,0,0
6,President,,REP,MATTHEW JOHN MATERN,0,0,0,0
6,President,,REP,"ROQUE ""ROCKY"" DE LA FUENTE GUERRA",0,0,0,0
6,President,,REP,UNCOMMITTED,0,0,0,0
6,President,,REP,ZOLTAN G. ISTVAN,0,0,0,0
6,JUSTICE SUPREME COURT PLACE 8,,REP,BRETT BUSBY,2,20,43,65
6,JUSTICE SUPREME COURT PLACE 6,,REP,JANE BLAND,2,22,43,67
6,JUSTICE SUPREME COURT PLACE 7,,REP,JEFF BOYD,2,22,42,66
6,"JUDGE,COURT OF CRIMINAL APPLEALS PLACE 4",,REP,KEVINE PATRICK YEARLY,2,22,43,67
6,"JUDGE,COURT OF CRIMINAL APPLEALS PLACE 3",,REP,BERT RICHARDSON,0,23,22,45
6,"JUDGE,COURT OF CRIMINAL APPLEALS PLACE 3",,REP,GINA PARKER,0,5,24,29
6,"JUDGE, COURT OF CRIMINAL APPLEALS PLACE 9",,REP,DAVID NEWELL,2,21,43,66
6,"DISTRICT ATTORNEY, 81ST JUDICIAL DISTRICT",,REP,AUDREY GOSSETT LOUIS,2,22,44,68
6,U.S. Senate,,REP,DWAYNE STOVALL,0,0,8,8
6,U.S. Senate,,REP,JOHN ANTHONY CASTRO,0,0,2,2
6,U.S. Senate,,REP,JOHN CORNYN,2,24,36,62
6,U.S. Senate,,REP,MARKY YANCEY,0,3,8,11
6,U.S. Senate,23,REP,VIRGIL BIERSCHWALE,1,0,0,1
6,U.S. House,23,REP,ALMA ARREDONDO-LYNCH,0,10,11,21
6,U.S. House,23,REP,ALIA URESTE,0,0,4,4
6,U.S. House,23,REP,BEN VAN WINKLE,0,1,3,4
6,U.S. House,23,REP,"CECIL B. ""BURT"" JONES",0,1,5,6
6,U.S. House,23,REP,DARWEN BOEDEKER,0,0,1,1
6,U.S. House,23,REP,JEFF MCFARLIN,1,2,6,9
6,U.S. House,23,REP,RAUL REYES,0,4,6,10
6,U.S. House,23,REP,SHARON BRECKENBRIDGE THOMAS,0,1,2,3
6,U.S. House,,REP,TONY GONZALES,2,8,14,24
6,"CHIEF JUSTICE, SUPREME COURT",,REP,NATHAN HECHT,2,23,43,68
6,Railroad Commissioner,,REP,"JAMES ""JIM"" WRIGHT",0,10,27,37
6,Railroad Commissioner,19,REP,RYAN SITTON,2,16,21,39
6,State Senate,,REP,"PETER P. ""PETE"" FLORES",2,22,42,66
6,"CHIEF JUSTICE, 4TH COURT OF APPEALS DISTRICT",,REP,RENEE YANTA,2,22,43,67
6,"MEMBER, STATE BOARD OF EDUCATION, DISTRICT 1",,REP,JENNIFER IVEY,2,22,44,68
6,REP. SHERIFF,,REP,"RAY TALAMANTES,SR",2,13,28,43
6,REP. SHERIFF,,REP,RICHARD GANDARA,1,9,20,30
8,President,,REP,BILL WELD,0,0,2,2
8,President,,REP,BOB ELY,0,0,0,0
8,President,,REP,DONALD J. TRUMP,0,19,10,29
8,President,,REP,JOE WALSH,0,0,0,0
8,President,,REP,MATTHEW JOHN MATERN,0,1,0,1
8,President,,REP,"ROQUE ""ROCKY"" DE LA FUENTE GUERRA",0,0,1,1
8,President,,REP,UNCOMMITTED,0,1,0,1
8,President,,REP,ZOLTAN G. ISTVAN,0,0,0,0
8,JUSTICE SUPREME COURT PLACE 8,,REP,BRETT BUSBY,0,16,6,22
8,JUSTICE SUPREME COURT PLACE 6,,REP,JANE BLAND,0,16,6,22
8,JUSTICE SUPREME COURT PLACE 7,,REP,JEFF BOYD,0,16,6,22
8,"JUDGE,COURT OF CRIMINAL APPLEALS PLACE 4",,REP,KEVINE PATRICK YEARLY,0,16,6,22
8,"JUDGE,COURT OF CRIMINAL APPLEALS PLACE 3",,REP,BERT RICHARDSON,0,9,3,12
8,"JUDGE,COURT OF CRIMINAL APPLEALS PLACE 3",,REP,GINA PARKER,0,8,5,13
8,"JUDGE, COURT OF CRIMINAL APPLEALS PLACE 9",,REP,DAVID NEWELL,0,16,6,22
8,"DISTRICT ATTORNEY, 81ST JUDICIAL DISTRICT",,REP,AUDREY GOSSETT LOUIS,0,16,6,22
8,U.S. Senate,,REP,DWAYNE STOVALL,0,1,1,2
8,U.S. Senate,,REP,JOHN ANTHONY CASTRO,0,3,4,7
8,U.S. Senate,,REP,JOHN CORNYN,0,14,3,17
8,U.S. Senate,,REP,MARKY YANCEY,0,2,1,3
8,U.S. Senate,23,REP,VIRGIL BIERSCHWALE,0,0,1,1
8,U.S. House,23,REP,ALMA ARREDONDO-LYNCH,0,7,1,8
8,U.S. House,23,REP,ALIA URESTE,0,0,0,0
8,U.S. House,23,REP,BEN VAN WINKLE,0,0,1,1
8,U.S. House,23,REP,"CECIL B. ""BURT"" JONES",0,2,0,2
8,U.S. House,23,REP,DARWEN BOEDEKER,0,0,0,0
8,U.S. House,23,REP,JEFF MCFARLIN,0,1,1,2
8,U.S. House,23,REP,RAUL REYES,0,3,0,3
8,U.S. House,23,REP,SHARON BRECKENBRIDGE THOMAS,0,1,0,1
8,U.S. House,,REP,TONY GONZALES,0,6,7,13
8,"CHIEF JUSTICE, SUPREME COURT",,REP,NATHAN HECHT,0,17,7,24
8,Railroad Commissioner,,REP,"JAMES ""JIM"" WRIGHT",0,9,9,18
8,Railroad Commissioner,19,REP,RYAN SITTON,0,10,2,12
8,State Senate,,REP,"PETER P. ""PETE"" FLORES",0,16,7,23
8,"CHIEF JUSTICE, 4TH COURT OF APPEALS DISTRICT",,REP,RENEE YANTA,0,16,7,23
8,"MEMBER, STATE BOARD OF EDUCATION, DISTRICT 1",,REP,JENNIFER IVEY,0,16,6,22
8,REP. SHERIFF,,REP,"RAY TALAMANTES,SR",0,14,2,16
8,REP. SHERIFF,,REP,RICHARD GANDARA,0,7,10,17
9,President,,REP,BILL WELD,0,0,0,0
9,President,,REP,BOB ELY,0,0,0,0
9,President,,REP,DONALD J. TRUMP,0,11,14,25
9,President,,REP,JOE WALSH,0,1,0,1
9,President,,REP,MATTHEW JOHN MATERN,0,0,0,0
9,President,,REP,"ROQUE ""ROCKY"" DE LA FUENTE GUERRA",0,0,1,1
9,President,,REP,UNCOMMITTED,0,0,0,0
9,President,,REP,ZOLTAN G. ISTVAN,0,0,0,0
9,JUSTICE SUPREME COURT PLACE 8,,REP,BRETT BUSBY,0,7,11,18
9,JUSTICE SUPREME COURT PLACE 6,,REP,JANE BLAND,0,8,11,19
9,JUSTICE SUPREME COURT PLACE 7,,REP,JEFF BOYD,0,8,12,20
9,"JUDGE,COURT OF CRIMINAL APPLEALS PLACE 4",,REP,KEVINE PATRICK YEARLY,0,7,12,19
9,"JUDGE,COURT OF CRIMINAL APPLEALS PLACE 3",,REP,BERT RICHARDSON,0,5,5,10
9,"JUDGE,COURT OF CRIMINAL APPLEALS PLACE 3",,REP,GINA PARKER,0,5,8,13
9,"JUDGE, COURT OF CRIMINAL APPLEALS PLACE 9",,REP,DAVID NEWELL,0,7,12,19
9,"DISTRICT ATTORNEY, 81ST JUDICIAL DISTRICT",,REP,AUDREY GOSSETT LOUIS,0,8,13,21
9,U.S. Senate,,REP,DWAYNE STOVALL,0,5,0,5
9,U.S. Senate,,REP,JOHN ANTHONY CASTRO,0,2,3,5
9,U.S. Senate,,REP,JOHN CORNYN,0,4,10,14
9,U.S. Senate,,REP,MARKY YANCEY,0,0,1,1
9,U.S. Senate,23,REP,VIRGIL BIERSCHWALE,0,0,0,0
9,U.S. House,23,REP,ALMA ARREDONDO-LYNCH,0,4,8,12
9,U.S. House,23,REP,ALIA URESTE,0,1,1,2
9,U.S. House,23,REP,BEN VAN WINKLE,0,0,0,0
9,U.S. House,23,REP,"CECIL B. ""BURT"" JONES",0,1,1,2
9,U.S. House,23,REP,DARWEN BOEDEKER,0,0,0,0
9,U.S. House,23,REP,JEFF MCFARLIN,0,0,0,0
9,U.S. House,23,REP,RAUL REYES,0,1,1,2
9,U.S. House,23,REP,SHARON BRECKENBRIDGE THOMAS,0,0,0,0
9,U.S. House,,REP,TONY GONZALES,0,4,2,6
9,"CHIEF JUSTICE, SUPREME COURT",,REP,NATHAN HECHT,0,7,12,19
9,Railroad Commissioner,,REP,"JAMES ""JIM"" WRIGHT",0,6,10,16
9,Railroad Commissioner,19,REP,RYAN SITTON,0,4,4,8
9,State Senate,,REP,"PETER P. ""PETE"" FLORES",0,8,12,20
9,"CHIEF JUSTICE, 4TH COURT OF APPEALS DISTRICT",,REP,RENEE YANTA,0,8,12,20
9,"MEMBER, STATE BOARD OF EDUCATION, DISTRICT 1",,REP,JENNIFER IVEY,0,8,13,21
9,REP. SHERIFF,,REP,"RAY TALAMANTES,SR",0,4,4,8
9,REP. SHERIFF,,REP,RICHARD GANDARA,0,7,9,16
10,President,,REP,BILL WELD,0,0,0,0
10,President,,REP,BOB ELY,0,0,0,0
10,President,,REP,DONALD J. TRUMP,0,22,31,53
10,President,,REP,JOE WALSH,0,0,0,0
10,President,,REP,MATTHEW JOHN MATERN,0,0,0,0
10,President,,REP,"ROQUE ""ROCKY"" DE LA FUENTE GUERRA",0,0,0,0
10,President,,REP,UNCOMMITTED,0,0,1,1
10,President,,REP,ZOLTAN G. ISTVAN,0,0,0,0
10,JUSTICE SUPREME COURT PLACE 8,,REP,BRETT BUSBY,0,19,20,39
10,JUSTICE SUPREME COURT PLACE 6,,REP,JANE BLAND,0,19,20,39
10,JUSTICE SUPREME COURT PLACE 7,,REP,JEFF BOYD,0,19,20,39
10,"JUDGE,COURT OF CRIMINAL APPLEALS PLACE 4",,REP,KEVINE PATRICK YEARLY,0,19,19,38
10,"JUDGE,COURT OF CRIMINAL APPLEALS PLACE 3",,REP,BERT RICHARDSON,0,14,12,26
10,"JUDGE,COURT OF CRIMINAL APPLEALS PLACE 3",,REP,GINA PARKER,0,6,12,18
10,"JUDGE, COURT OF CRIMINAL APPLEALS PLACE 9",,REP,DAVID NEWELL,0,19,20,39
10,"DISTRICT ATTORNEY, 81ST JUDICIAL DISTRICT",,REP,AUDREY GOSSETT LOUIS,0,20,20,40
10,U.S. Senate,,REP,DWAYNE STOVALL,0,2,4,6
10,U.S. Senate,,REP,JOHN ANTHONY CASTRO,0,3,5,8
10,U.S. Senate,,REP,JOHN CORNYN,0,14,15,29
10,U.S. Senate,,REP,MARKY YANCEY,0,1,0,1
10,U.S. Senate,23,REP,VIRGIL BIERSCHWALE,0,0,0,0
10,U.S. House,23,REP,ALMA ARREDONDO-LYNCH,0,12,14,26
10,U.S. House,23,REP,ALIA URESTE,0,1,0,1
10,U.S. House,23,REP,BEN VAN WINKLE,0,0,1,1
10,U.S. House,23,REP,"CECIL B. ""BURT"" JONES",0,1,0,1
10,U.S. House,23,REP,DARWEN BOEDEKER,0,0,0,0
10,U.S. House,23,REP,JEFF MCFARLIN,0,0,2,2
10,U.S. House,23,REP,RAUL REYES,0,3,2,5
10,U.S. House,23,REP,SHARON BRECKENBRIDGE THOMAS,0,0,1,1
10,U.S. House,,REP,TONY GONZALES,0,5,7,12
10,"CHIEF JUSTICE, SUPREME COURT",,REP,NATHAN HECHT,0,19,18,37
10,Railroad Commissioner,,REP,"JAMES ""JIM"" WRIGHT",0,12,11,23
10,Railroad Commissioner,19,REP,RYAN SITTON,0,7,15,22
10,State Senate,,REP,"PETER P. ""PETE"" FLORES",0,20,22,42
10,"CHIEF JUSTICE, 4TH COURT OF APPEALS DISTRICT",,REP,RENEE YANTA,0,18,20,38
10,"MEMBER, STATE BOARD OF EDUCATION, DISTRICT 1",,REP,JENNIFER IVEY,0,19,20,39
10,REP. SHERIFF,,REP,"RAY TALAMANTES,SR",0,10,12,22
10,REP. SHERIFF,,REP,RICHARD GANDARA,0,6,10,16