county,precinct,office,district,party,candidate,election_day,absentee,early_voting,votes
Young,5,U.S. Senate,,REP,Ted Cruz,260,88,310,658
Young,5,U.S. Senate,,REP,"Bruce Jacobson, Jr.",13,4,16,33
Young,5,U.S. Senate,,REP,Geraldine Sam,4,0,4,8
Young,5,U.S. Senate,,REP,Stefano de Stefano,1,0,2,3
Young,5,U.S. Senate,,REP,Mary Miller,6,4,22,32
Young,5,U.S. House,19,REP,Jodey Arrington,253,81,325,659
Young,5,Governor,,REP,Greg Abbott,262,95,304,661
Young,5,Governor,,REP,Barbara Krueger,16,1,38,55
Young,5,Governor,,REP,SECEDE Kilgore,1,0,1,2
Young,5,Lieutenant Governor,,REP,Scott Milder,75,17,129,221
Young,5,Lieutenant Governor,,REP,Dan Patrick,190,79,220,489
Young,5,Attorney General,,REP,Ken Paxton,250,83,308,641
Young,5,Comptroller of Public Accounts,,REP,Glenn Hegar,240,82,304,626
Young,5,Commissioner of the General Land Office,,REP,Rick Range,25,11,26,62
Young,5,Commissioner of the General Land Office,,REP,George P. Bush,176,50,211,437
Young,5,Commissioner of the General Land Office,,REP,Jerry Patterson,52,23,77,152
Young,5,Commissioner of the General Land Office,,REP,Davey Edwards,6,6,22,34
Young,5,Commissioner of Agriculture,,REP,Jim Hogan,79,23,100,202
Young,5,Commissioner of Agriculture,,REP,Sid Miller,123,37,159,319
Young,5,Commissioner of Agriculture,,REP,Trey Blocker,32,18,44,94
Young,5,Railroad Commissioner,,REP,Christi Craddick,183,69,242,494
Young,5,Railroad Commissioner,,REP,Weston Martinez,53,12,57,122
Young,5,"Justice, Supreme Court, Place 2",,REP,Jimmy Blacklock,231,76,289,596
Young,5,"Justice, Supreme Court, Place 4",,REP,John Devine,227,78,289,594
Young,5,"Justice, Supreme Court, Place 6",,REP,Jeff Brown,228,75,290,593
Young,5,"Presiding Judge, Court of Criminal Appeals",,REP,David Bridges,149,43,188,380
Young,5,"Presiding Judge, Court of Criminal Appeals",,REP,Sharon Keller,72,29,108,209
Young,5,"Judge, Court of Criminal Appeals, Place 7",,REP,Barbara Parker Hervey,218,76,287,581
Young,5,"Judge, Court of Criminal Appeals, Place 8",,REP,Jay Brandon,100,34,137,271
Young,5,"Judge, Court of Criminal Appeals, Place 8",,REP,Michelle Slaughter,80,21,100,201
Young,5,"Judge, Court of Criminal Appeals, Place 8",,REP,Dib Waldrip,25,14,53,92
Young,5,State Senator,30,REP,Pat Fallon,165,66,237,468
Young,5,State Senator,30,REP,Craig Carter,38,12,47,97
Young,5,State Senator,30,REP,Craig Estes,69,18,66,153
Young,5,State Representative,68,REP,Drew Springer,250,82,317,649
Young,5,"Chief Justice, 2nd Court of Appeals District",,REP,Bonnie Sudderth,220,78,282,580
Young,5,"Justice, 2nd Court of Appeals District, Place No. 4",,REP,Wade Birdwell,222,77,285,584
Young,5,"Justice, 2nd Court of Appeals District, Place No. 5",,REP,Dabney Bassel,218,77,281,576
Young,5,"Justice, 2nd Court of Appeals District, Place No. 6",,REP,Mark Pittman,222,77,280,579
Young,5,County Judge,,REP,John C. Bullock,191,77,233,501
Young,5,County Judge,,REP,Paul M. Hemphill,97,19,126,242
Young,5,District Clerk,,REP,Jamie Freeze Land,248,88,311,647
Young,5,County Clerk,,REP,Kay Jennings Hardin,250,88,318,656
Young,5,County Treasurer,,REP,Ann B. Daily,246,86,312,644
Young,5,"County Commissioner, Precinct No. 2",,REP,Matt Pruitt,119,52,195,366
Young,5,"County Commissioner, Precinct No. 2",,REP,Larry Pratt,97,28,111,236
Young,5,"County Commissioner, Precinct No. 2",,REP,Les Remington,63,14,45,122
Young,5,"Justice of the Peace, Precinct No. 1",,REP,Jason Hearne,93,25,167,285
Young,5,"Justice of the Peace, Precinct No. 1",,REP,Randy Saylor,72,21,78,171
Young,5,"Justice of the Peace, Precinct No. 1",,REP,Norman B. Carpenter,54,19,60,133
Young,5,"Justice of the Peace, Precinct No. 1",,REP,Jabe Underwood,60,17,49,126
Young,5,County Chairman,,REP,Kyle Zohn Milam,245,84,326,655
Young,5,U.S. Senate,,DEM,Edward Kimbrough,6,4,3,13
Young,5,U.S. Senate,,DEM,Beto O'Rourke,7,4,11,22
Young,5,U.S. Senate,,DEM,Sema Hernandez,4,4,0,8
Young,5,U.S. House,19,DEM,Miguel Levario,16,12,13,41
Young,5,Governor,,DEM,"Cedric Davis, Sr.",4,0,0,4
Young,5,Governor,,DEM,Joe Mumbach,0,0,1,1
Young,5,Governor,,DEM,Jeffrey Payne,1,1,0,2
Young,5,Governor,,DEM,James Jolly Clark,0,1,2,3
Young,5,Governor,,DEM,Grady Yarbrough,3,1,0,4
Young,5,Governor,,DEM,Tom Wakely,0,0,0,0
Young,5,Governor,,DEM,Andrew White,3,2,4,9
Young,5,Governor,,DEM,Adrian Ocegueda,0,0,1,1
Young,5,Governor,,DEM,Lupe Valdez,5,7,6,18
Young,5,Lieutenant Governor,,DEM,Mike Collier,8,5,8,21
Young,5,Lieutenant Governor,,DEM,Michael Cooper,9,7,6,22
Young,5,Attorney General,,DEM,Justin Nelson,17,12,14,43
Young,5,Comptroller of Public Accounts,,DEM,Tim Mahoney,10,7,9,26
Young,5,Comptroller of Public Accounts,,DEM,Joi Chevalier,6,5,5,16
Young,5,Commissioner of the General Land Office,,DEM,Miguel Suazo,12,9,8,29
Young,5,Commissioner of the General Land Office,,DEM,Tex Morgan,3,3,6,12
Young,5,Commissioner of Agriculture,,DEM,Kim Olson,15,12,13,40
Young,5,Railroad Commissioner,,DEM,Roman McAllen,8,5,9,22
Young,5,Railroad Commissioner,,DEM,Chris Spellmon,8,7,4,19
Young,5,"Justice, Supreme Court, Place 2",,DEM,Steven Kirkland,15,12,13,40
Young,5,"Justice, Supreme Court, Place 4",,DEM,R.K. Sandill,15,11,14,40
Young,5,"Justice, Supreme Court, Place 6",,DEM,Kathy Cheng,16,12,14,42
Young,5,"Presiding Judge, Court of Criminal Appeals",,DEM,Maria T. (Terri) Jackson,17,12,14,43
Young,5,"Judge, Court of Criminal Appeals, Place 7",,DEM,Ramona Franklin,16,12,14,42
Young,5,State Senator,30,DEM,Kevin Lopez,16,12,14,42
Young,5,"Justice, 2nd Court of Appeals District, Place No. 5",,DEM,Delonia A. Watson,15,12,14,41
Young,5,County Chairman,,DEM,Fran Edens,16,12,13,41
Young,5,Proposition #1,,DEM,Yes,17,13,14,44
Young,5,Proposition #1,,DEM,No,1,0,2,3
Young,5,Proposition #2,,DEM,Yes,17,11,14,42
Young,5,Proposition #2,,DEM,No,1,2,1,4
Young,5,Proposition #3,,DEM,Yes,18,13,13,44
Young,5,Proposition #3,,DEM,No,0,0,3,3
Young,5,Proposition #4,,DEM,Yes,16,13,14,43
Young,5,Proposition #4,,DEM,No,2,0,2,4
Young,5,Proposition #5,,DEM,Yes,15,12,15,42
Young,5,Proposition #5,,DEM,No,2,1,1,4
Young,5,Proposition #6,,DEM,Yes,17,13,14,44
Young,5,Proposition #6,,DEM,No,0,0,1,1
Young,5,Proposition #7,,DEM,Yes,17,13,14,44
Young,5,Proposition #7,,DEM,No,1,0,1,2
Young,5,Proposition #8,,DEM,Yes,17,11,14,42
Young,5,Proposition #8,,DEM,No,1,2,2,5
Young,5,Proposition #9,,DEM,Yes,18,12,13,43
Young,5,Proposition #9,,DEM,No,0,1,2,3
Young,5,Proposition #10,,DEM,Yes,18,11,15,44
Young,5,Proposition #10,,DEM,No,0,2,1,3
Young,5,Proposition #11,,DEM,Yes,15,13,15,43
Young,5,Proposition #11,,DEM,No,2,0,1,3
Young,5,Proposition #12,,DEM,Yes,18,13,13,44
Young,5,Proposition #12,,DEM,No,0,0,2,2
Young,5,Proposition 1,,DEM,YES,192,60,225,477
Young,5,Proposition 1,,DEM,NO,71,28,113,212
Young,5,Proposition 2,,DEM,YES,246,84,322,652
Young,5,Proposition 2,,DEM,NO,36,8,30,74
Young,5,Proposition 3,,DEM,YES,243,90,303,636
Young,5,Proposition 3,,DEM,NO,24,3,45,72
Young,5,Proposition 4,,DEM,YES,252,90,307,649
Young,5,Proposition 4,,DEM,NO,23,4,37,64
Young,5,Proposition 5,,DEM,YES,221,77,243,541
Young,5,Proposition 5,,DEM,NO,58,15,110,183
Young,5,Proposition 6,,DEM,YES,266,91,335,692
Young,5,Proposition 6,,DEM,NO,12,3,22,37
Young,5,Proposition 7,,DEM,YES,204,67,247,518
Young,5,Proposition 7,,DEM,NO,68,22,107,197
Young,5,Proposition 8,,DEM,YES,273,90,348,711
Young,5,Proposition 8,,DEM,NO,6,4,11,21
Young,5,Proposition 9,,DEM,YES,259,89,315,663
Young,5,Proposition 9,,DEM,NO,22,4,42,68
Young,5,Proposition 10,,DEM,YES,266,93,328,687
Young,5,Proposition 10,,DEM,NO,9,1,15,25
Young,5,Proposition 11,,DEM,YES,246,92,308,646
Young,5,Proposition 11,,DEM,NO,35,3,48,86
Young,6,U.S. Senate,,REP,Ted Cruz,33,8,27,68
Young,6,U.S. Senate,,REP,"Bruce Jacobson, Jr.",1,0,1,2
Young,6,U.S. Senate,,REP,Geraldine Sam,0,0,1,1
Young,6,U.S. Senate,,REP,Stefano de Stefano,0,0,0,0
Young,6,U.S. Senate,,REP,Mary Miller,2,0,0,2
Young,6,U.S. House,19,REP,Jodey Arrington,32,7,25,64
Young,6,Governor,,REP,Greg Abbott,34,8,26,68
Young,6,Governor,,REP,Barbara Krueger,0,0,2,2
Young,6,Governor,,REP,SECEDE Kilgore,1,0,0,1
Young,6,Lieutenant Governor,,REP,Scott Milder,9,0,5,14
Young,6,Lieutenant Governor,,REP,Dan Patrick,23,7,23,53
Young,6,Attorney General,,REP,Ken Paxton,32,7,24,63
Young,6,Comptroller of Public Accounts,,REP,Glenn Hegar,29,7,22,58
Young,6,Commissioner of the General Land Office,,REP,Rick Range,7,3,2,12
Young,6,Commissioner of the General Land Office,,REP,George P. Bush,21,4,18,43
Young,6,Commissioner of the General Land Office,,REP,Jerry Patterson,6,1,3,10
Young,6,Commissioner of the General Land Office,,REP,Davey Edwards,0,0,2,2
Young,6,Commissioner of Agriculture,,REP,Jim Hogan,12,3,2,17
Young,6,Commissioner of Agriculture,,REP,Sid Miller,16,2,16,34
Young,6,Commissioner of Agriculture,,REP,Trey Blocker,4,1,6,11
Young,6,Railroad Commissioner,,REP,Christi Craddick,25,6,22,53
Young,6,Railroad Commissioner,,REP,Weston Martinez,6,1,0,7
Young,6,"Justice, Supreme Court, Place 2",,REP,Jimmy Blacklock,30,8,21,59
Young,6,"Justice, Supreme Court, Place 4",,REP,John Devine,29,8,21,58
Young,6,"Justice, Supreme Court, Place 6",,REP,Jeff Brown,29,8,22,59
Young,6,"Presiding Judge, Court of Criminal Appeals",,REP,David Bridges,14,4,16,34
Young,6,"Presiding Judge, Court of Criminal Appeals",,REP,Sharon Keller,15,2,6,23
Young,6,"Judge, Court of Criminal Appeals, Place 7",,REP,Barbara Parker Hervey,29,8,21,58
Young,6,"Judge, Court of Criminal Appeals, Place 8",,REP,Jay Brandon,11,2,11,24
Young,6,"Judge, Court of Criminal Appeals, Place 8",,REP,Michelle Slaughter,15,3,9,27
Young,6,"Judge, Court of Criminal Appeals, Place 8",,REP,Dib Waldrip,1,1,1,3
Young,6,State Senator,30,REP,Pat Fallon,27,6,19,52
Young,6,State Senator,30,REP,Craig Carter,2,1,5,8
Young,6,State Senator,30,REP,Craig Estes,5,1,5,11
Young,6,State Representative,68,REP,Drew Springer,31,8,22,61
Young,6,"Chief Justice, 2nd Court of Appeals District",,REP,Bonnie Sudderth,29,8,21,58
Young,6,"Justice, 2nd Court of Appeals District, Place No. 4",,REP,Wade Birdwell,28,8,20,56
Young,6,"Justice, 2nd Court of Appeals District, Place No. 5",,REP,Dabney Bassel,29,7,21,57
Young,6,"Justice, 2nd Court of Appeals District, Place No. 6",,REP,Mark Pittman,29,8,22,59
Young,6,County Judge,,REP,John C. Bullock,24,5,15,44
Young,6,County Judge,,REP,Paul M. Hemphill,12,3,13,28
Young,6,District Clerk,,REP,Jamie Freeze Land,29,8,23,60
Young,6,County Clerk,,REP,Kay Jennings Hardin,29,8,22,59
Young,6,County Treasurer,,REP,Ann B. Daily,29,8,23,60
Young,6,"County Commissioner, Precinct No. 2",,REP,Matt Pruitt,13,1,8,22
Young,6,"County Commissioner, Precinct No. 2",,REP,Larry Pratt,16,5,14,35
Young,6,"County Commissioner, Precinct No. 2",,REP,Les Remington,7,2,5,14
Young,6,"Justice of the Peace, Precinct No. 1",,REP,Jason Hearne,10,1,7,18
Young,6,"Justice of the Peace, Precinct No. 1",,REP,Randy Saylor,10,1,5,16
Young,6,"Justice of the Peace, Precinct No. 1",,REP,Norman B. Carpenter,5,3,11,19
Young,6,"Justice of the Peace, Precinct No. 1",,REP,Jabe Underwood,11,3,3,17
Young,6,County Chairman,,REP,Kyle Zohn Milam,31,8,22,61
Young,6,U.S. Senate,,DEM,Edward Kimbrough,0,1,0,1
Young,6,U.S. Senate,,DEM,Beto O'Rourke,0,0,0,0
Young,6,U.S. Senate,,DEM,Sema Hernandez,1,0,0,1
Young,6,U.S. House,19,DEM,Miguel Levario,1,1,0,2
Young,6,Governor,,DEM,"Cedric Davis, Sr.",0,0,0,0
Young,6,Governor,,DEM,Joe Mumbach,0,0,0,0
Young,6,Governor,,DEM,Jeffrey Payne,0,0,0,0
Young,6,Governor,,DEM,James Jolly Clark,0,0,0,0
Young,6,Governor,,DEM,Grady Yarbrough,0,1,0,1
Young,6,Governor,,DEM,Tom Wakely,0,0,0,0
Young,6,Governor,,DEM,Andrew White,0,0,0,0
Young,6,Governor,,DEM,Adrian Ocegueda,0,0,0,0
Young,6,Governor,,DEM,Lupe Valdez,1,0,0,1
Young,6,Lieutenant Governor,,DEM,Mike Collier,0,0,0,0
Young,6,Lieutenant Governor,,DEM,Michael Cooper,1,1,0,2
Young,6,Attorney General,,DEM,Justin Nelson,0,1,0,1
Young,6,Comptroller of Public Accounts,,DEM,Tim Mahoney,0,1,0,1
Young,6,Comptroller of Public Accounts,,DEM,Joi Chevalier,1,0,0,1
Young,6,Commissioner of the General Land Office,,DEM,Miguel Suazo,0,1,0,1
Young,6,Commissioner of the General Land Office,,DEM,Tex Morgan,0,0,0,0
Young,6,Commissioner of Agriculture,,DEM,Kim Olson,0,1,0,1
Young,6,Railroad Commissioner,,DEM,Roman McAllen,0,1,0,1
Young,6,Railroad Commissioner,,DEM,Chris Spellmon,0,0,0,0
Young,6,"Justice, Supreme Court, Place 2",,DEM,Steven Kirkland,1,1,0,2
Young,6,"Justice, Supreme Court, Place 4",,DEM,R.K. Sandill,0,1,0,1
Young,6,"Justice, Supreme Court, Place 6",,DEM,Kathy Cheng,0,1,0,1
Young,6,"Presiding Judge, Court of Criminal Appeals",,DEM,Maria T. (Terri) Jackson,0,1,0,1
Young,6,"Judge, Court of Criminal Appeals, Place 7",,DEM,Ramona Franklin,0,1,0,1
Young,6,State Senator,30,DEM,Kevin Lopez,1,1,0,2
Young,6,"Justice, 2nd Court of Appeals District, Place No. 5",,DEM,Delonia A. Watson,0,1,0,1
Young,6,County Chairman,,DEM,Fran Edens,1,1,0,2
Young,6,Proposition #1,,DEM,Yes,1,0,0,1
Young,6,Proposition #1,,DEM,No,0,1,0,1
Young,6,Proposition #2,,DEM,Yes,1,0,0,1
Young,6,Proposition #2,,DEM,No,0,1,0,1
Young,6,Proposition #3,,DEM,Yes,1,0,0,1
Young,6,Proposition #3,,DEM,No,0,1,0,1
Young,6,Proposition #4,,DEM,Yes,1,0,0,1
Young,6,Proposition #4,,DEM,No,0,1,0,1
Young,6,Proposition #5,,DEM,Yes,1,0,0,1
Young,6,Proposition #5,,DEM,No,0,1,0,1
Young,6,Proposition #6,,DEM,Yes,1,1,0,2
Young,6,Proposition #6,,DEM,No,0,0,0,0
Young,6,Proposition #7,,DEM,Yes,1,1,0,2
Young,6,Proposition #7,,DEM,No,0,0,0,0
Young,6,Proposition #8,,DEM,Yes,1,1,0,2
Young,6,Proposition #8,,DEM,No,0,0,0,0
Young,6,Proposition #9,,DEM,Yes,0,1,0,1
Young,6,Proposition #9,,DEM,No,1,0,0,1
Young,6,Proposition #10,,DEM,Yes,0,1,0,1
Young,6,Proposition #10,,DEM,No,1,0,0,1
Young,6,Proposition #11,,DEM,Yes,1,1,0,2
Young,6,Proposition #11,,DEM,No,0,0,0,0
Young,6,Proposition #12,,DEM,Yes,1,1,0,2
Young,6,Proposition #12,,DEM,No,0,0,0,0
Young,6,Proposition 1,,DEM,YES,25,5,20,50
Young,6,Proposition 1,,DEM,NO,10,2,8,20
Young,6,Proposition 2,,DEM,YES,34,7,28,69
Young,6,Proposition 2,,DEM,NO,2,0,1,3
Young,6,Proposition 3,,DEM,YES,33,7,26,66
Young,6,Proposition 3,,DEM,NO,2,0,1,3
Young,6,Proposition 4,,DEM,YES,35,6,27,68
Young,6,Proposition 4,,DEM,NO,0,1,1,2
Young,6,Proposition 5,,DEM,YES,33,6,22,61
Young,6,Proposition 5,,DEM,NO,3,2,6,11
Young,6,Proposition 6,,DEM,YES,34,7,27,68
Young,6,Proposition 6,,DEM,NO,1,1,2,4
Young,6,Proposition 7,,DEM,YES,24,7,21,52
Young,6,Proposition 7,,DEM,NO,12,1,7,20
Young,6,Proposition 8,,DEM,YES,35,7,25,67
Young,6,Proposition 8,,DEM,NO,1,0,2,3
Young,6,Proposition 9,,DEM,YES,34,7,27,68
Young,6,Proposition 9,,DEM,NO,2,1,2,5
Young,6,Proposition 10,,DEM,YES,34,8,24,66
Young,6,Proposition 10,,DEM,NO,1,0,4,5
Young,6,Proposition 11,,DEM,YES,30,8,27,65
Young,6,Proposition 11,,DEM,NO,5,0,1,6
Young,7,U.S. Senate,,REP,Ted Cruz,29,3,21,53
Young,7,U.S. Senate,,REP,"Bruce Jacobson, Jr.",2,0,0,2
Young,7,U.S. Senate,,REP,Geraldine Sam,0,0,0,0
Young,7,U.S. Senate,,REP,Stefano de Stefano,1,0,0,1
Young,7,U.S. Senate,,REP,Mary Miller,2,0,1,3
Young,7,U.S. House,19,REP,Jodey Arrington,30,2,18,50
Young,7,Governor,,REP,Greg Abbott,29,3,20,52
Young,7,Governor,,REP,Barbara Krueger,5,0,2,7
Young,7,Governor,,REP,SECEDE Kilgore,0,0,0,0
Young,7,Lieutenant Governor,,REP,Scott Milder,10,0,7,17
Young,7,Lieutenant Governor,,REP,Dan Patrick,23,3,14,40
Young,7,Attorney General,,REP,Ken Paxton,32,2,17,51
Young,7,Comptroller of Public Accounts,,REP,Glenn Hegar,29,2,18,49
Young,7,Commissioner of the General Land Office,,REP,Rick Range,0,0,4,4
Young,7,Commissioner of the General Land Office,,REP,George P. Bush,16,2,8,26
Young,7,Commissioner of the General Land Office,,REP,Jerry Patterson,11,2,8,21
Young,7,Commissioner of the General Land Office,,REP,Davey Edwards,5,0,1,6
Young,7,Commissioner of Agriculture,,REP,Jim Hogan,11,1,5,17
Young,7,Commissioner of Agriculture,,REP,Sid Miller,17,2,10,29
Young,7,Commissioner of Agriculture,,REP,Trey Blocker,6,0,4,10
Young,7,Railroad Commissioner,,REP,Christi Craddick,18,3,15,36
Young,7,Railroad Commissioner,,REP,Weston Martinez,13,0,3,16
Young,7,"Justice, Supreme Court, Place 2",,REP,Jimmy Blacklock,26,2,16,44
Young,7,"Justice, Supreme Court, Place 4",,REP,John Devine,25,2,15,42
Young,7,"Justice, Supreme Court, Place 6",,REP,Jeff Brown,25,2,16,43
Young,7,"Presiding Judge, Court of Criminal Appeals",,REP,David Bridges,24,2,15,41
Young,7,"Presiding Judge, Court of Criminal Appeals",,REP,Sharon Keller,3,1,3,7
Young,7,"Judge, Court of Criminal Appeals, Place 7",,REP,Barbara Parker Hervey,25,2,16,43
Young,7,"Judge, Court of Criminal Appeals, Place 8",,REP,Jay Brandon,12,3,10,25
Young,7,"Judge, Court of Criminal Appeals, Place 8",,REP,Michelle Slaughter,5,0,4,9
Young,7,"Judge, Court of Criminal Appeals, Place 8",,REP,Dib Waldrip,11,0,3,14
Young,7,State Senator,30,REP,Pat Fallon,16,4,15,35
Young,7,State Senator,30,REP,Craig Carter,6,0,3,9
Young,7,State Senator,30,REP,Craig Estes,11,0,4,15
Young,7,State Representative,68,REP,Drew Springer,28,2,18,48
Young,7,"Chief Justice, 2nd Court of Appeals District",,REP,Bonnie Sudderth,25,2,17,44
Young,7,"Justice, 2nd Court of Appeals District, Place No. 4",,REP,Wade Birdwell,24,2,17,43
Young,7,"Justice, 2nd Court of Appeals District, Place No. 5",,REP,Dabney Bassel,23,2,14,39
Young,7,"Justice, 2nd Court of Appeals District, Place No. 6",,REP,Mark Pittman,24,2,16,42
Young,7,County Judge,,REP,John C. Bullock,29,2,15,46
Young,7,County Judge,,REP,Paul M. Hemphill,6,2,7,15
Young,7,District Clerk,,REP,Jamie Freeze Land,26,3,17,46
Young,7,County Clerk,,REP,Kay Jennings Hardin,27,2,16,45
Young,7,County Treasurer,,REP,Ann B. Daily,26,3,17,46
Young,7,"County Commissioner, Precinct No. 2",,REP,Matt Pruitt,16,1,13,30
Young,7,"County Commissioner, Precinct No. 2",,REP,Larry Pratt,15,2,8,25
Young,7,"County Commissioner, Precinct No. 2",,REP,Les Remington,2,1,1,4
Young,7,"Justice of the Peace, Precinct No. 3",,REP,Stan G. Mahler,13,2,7,22
Young,7,"Justice of the Peace, Precinct No. 3",,REP,Becky Perez,17,3,15,35
Young,7,"Constable, Precinct No. 3 Unexpired Term",,REP,Cliff Blackstock,18,2,16,36
Young,7,"Constable, Precinct No. 3 Unexpired Term",,REP,Larry Thacker,14,2,3,19
Young,7,County Chairman,,REP,Kyle Zohn Milam,24,2,18,44
Young,7,U.S. Senate,,DEM,Edward Kimbrough,1,0,0,1
Young,7,U.S. Senate,,DEM,Beto O'Rourke,1,0,2,3
Young,7,U.S. Senate,,DEM,Sema Hernandez,0,0,0,0
Young,7,U.S. House,19,DEM,Miguel Levario,1,0,2,3
Young,7,Governor,,DEM,"Cedric Davis, Sr.",0,0,1,1
Young,7,Governor,,DEM,Joe Mumbach,0,0,0,0
Young,7,Governor,,DEM,Jeffrey Payne,0,0,0,0
Young,7,Governor,,DEM,James Jolly Clark,0,0,0,0
Young,7,Governor,,DEM,Grady Yarbrough,1,0,1,2
Young,7,Governor,,DEM,Tom Wakely,0,0,0,0
Young,7,Governor,,DEM,Andrew White,0,0,0,0
Young,7,Governor,,DEM,Adrian Ocegueda,0,0,0,0
Young,7,Governor,,DEM,Lupe Valdez,0,0,0,0
Young,7,Lieutenant Governor,,DEM,Mike Collier,0,0,1,1
Young,7,Lieutenant Governor,,DEM,Michael Cooper,1,0,0,1
Young,7,Attorney General,,DEM,Justin Nelson,1,0,1,2
Young,7,Comptroller of Public Accounts,,DEM,Tim Mahoney,1,0,0,1
Young,7,Comptroller of Public Accounts,,DEM,Joi Chevalier,0,0,0,0
Young,7,Commissioner of the General Land Office,,DEM,Miguel Suazo,0,0,0,0
Young,7,Commissioner of the General Land Office,,DEM,Tex Morgan,1,0,0,1
Young,7,Commissioner of Agriculture,,DEM,Kim Olson,1,0,1,2
Young,7,Railroad Commissioner,,DEM,Roman McAllen,0,0,0,0
Young,7,Railroad Commissioner,,DEM,Chris Spellmon,1,0,0,1
Young,7,"Justice, Supreme Court, Place 2",,DEM,Steven Kirkland,1,0,1,2
Young,7,"Justice, Supreme Court, Place 4",,DEM,R.K. Sandill,1,0,1,2
Young,7,"Justice, Supreme Court, Place 6",,DEM,Kathy Cheng,1,0,1,2
Young,7,"Presiding Judge, Court of Criminal Appeals",,DEM,Maria T. (Terri) Jackson,1,0,1,2
Young,7,"Judge, Court of Criminal Appeals, Place 7",,DEM,Ramona Franklin,1,0,1,2
Young,7,State Senator,30,DEM,Kevin Lopez,0,0,1,1
Young,7,"Justice, 2nd Court of Appeals District, Place No. 5",,DEM,Delonia A. Watson,1,0,1,2
Young,7,County Chairman,,DEM,Fran Edens,1,0,1,2
Young,7,Proposition #1,,DEM,Yes,2,0,1,3
Young,7,Proposition #1,,DEM,No,0,0,1,1
Young,7,Proposition #2,,DEM,Yes,1,0,2,3
Young,7,Proposition #2,,DEM,No,1,0,0,1
Young,7,Proposition #3,,DEM,Yes,2,0,2,4
Young,7,Proposition #3,,DEM,No,0,0,0,0
Young,7,Proposition #4,,DEM,Yes,2,0,2,4
Young,7,Proposition #4,,DEM,No,0,0,0,0
Young,7,Proposition #5,,DEM,Yes,2,0,2,4
Young,7,Proposition #5,,DEM,No,0,0,0,0
Young,7,Proposition #6,,DEM,Yes,2,0,1,3
Young,7,Proposition #6,,DEM,No,0,0,1,1
Young,7,Proposition #7,,DEM,Yes,2,0,1,3
Young,7,Proposition #7,,DEM,No,0,0,1,1
Young,7,Proposition #8,,DEM,Yes,2,0,2,4
Young,7,Proposition #8,,DEM,No,0,0,0,0
Young,7,Proposition #9,,DEM,Yes,2,0,2,4
Young,7,Proposition #9,,DEM,No,0,0,0,0
Young,7,Proposition #10,,DEM,Yes,2,0,1,3
Young,7,Proposition #10,,DEM,No,0,0,1,1
Young,7,Proposition #11,,DEM,Yes,2,0,1,3
Young,7,Proposition #11,,DEM,No,0,0,1,1
Young,7,Proposition #12,,DEM,Yes,2,0,2,4
Young,7,Proposition #12,,DEM,No,0,0,0,0
Young,7,Proposition 1,,DEM,YES,20,2,17,39
Young,7,Proposition 1,,DEM,NO,9,2,5,16
Young,7,Proposition 2,,DEM,YES,31,4,20,55
Young,7,Proposition 2,,DEM,NO,0,0,2,2
Young,7,Proposition 3,,DEM,YES,26,4,18,48
Young,7,Proposition 3,,DEM,NO,8,0,4,12
Young,7,Proposition 4,,DEM,YES,31,4,20,55
Young,7,Proposition 4,,DEM,NO,2,0,1,3
Young,7,Proposition 5,,DEM,YES,22,0,17,39
Young,7,Proposition 5,,DEM,NO,12,4,4,20
Young,7,Proposition 6,,DEM,YES,32,4,22,58
Young,7,Proposition 6,,DEM,NO,1,0,0,1
Young,7,Proposition 7,,DEM,YES,26,2,16,44
Young,7,Proposition 7,,DEM,NO,7,2,5,14
Young,7,Proposition 8,,DEM,YES,32,4,22,58
Young,7,Proposition 8,,DEM,NO,1,0,0,1
Young,7,Proposition 9,,DEM,YES,26,4,21,51
Young,7,Proposition 9,,DEM,NO,5,0,0,5
Young,7,Proposition 10,,DEM,YES,32,4,20,56
Young,7,Proposition 10,,DEM,NO,1,0,2,3
Young,7,Proposition 11,,DEM,YES,31,4,19,54
Young,7,Proposition 11,,DEM,NO,2,0,3,5
Young,10,U.S. Senate,,REP,Ted Cruz,75,15,11,101
Young,10,U.S. Senate,,REP,"Bruce Jacobson, Jr.",2,1,1,4
Young,10,U.S. Senate,,REP,Geraldine Sam,1,0,0,1
Young,10,U.S. Senate,,REP,Stefano de Stefano,0,0,0,0
Young,10,U.S. Senate,,REP,Mary Miller,2,0,0,2
Young,10,U.S. House,19,REP,Jodey Arrington,68,13,8,89
Young,10,Governor,,REP,Greg Abbott,76,18,12,106
Young,10,Governor,,REP,Barbara Krueger,4,1,0,5
Young,10,Governor,,REP,SECEDE Kilgore,0,0,0,0
Young,10,Lieutenant Governor,,REP,Scott Milder,20,4,3,27
Young,10,Lieutenant Governor,,REP,Dan Patrick,53,12,8,73
Young,10,Attorney General,,REP,Ken Paxton,69,14,8,91
Young,10,Comptroller of Public Accounts,,REP,Glenn Hegar,65,12,8,85
Young,10,Commissioner of the General Land Office,,REP,Rick Range,9,2,1,12
Young,10,Commissioner of the General Land Office,,REP,George P. Bush,41,10,8,59
Young,10,Commissioner of the General Land Office,,REP,Jerry Patterson,16,3,0,19
Young,10,Commissioner of the General Land Office,,REP,Davey Edwards,6,1,1,8
Young,10,Commissioner of Agriculture,,REP,Jim Hogan,16,5,4,25
Young,10,Commissioner of Agriculture,,REP,Sid Miller,34,5,5,44
Young,10,Commissioner of Agriculture,,REP,Trey Blocker,16,4,1,21
Young,10,Railroad Commissioner,,REP,Christi Craddick,44,14,9,67
Young,10,Railroad Commissioner,,REP,Weston Martinez,17,1,1,19
Young,10,"Justice, Supreme Court, Place 2",,REP,Jimmy Blacklock,59,11,7,77
Young,10,"Justice, Supreme Court, Place 4",,REP,John Devine,57,11,7,75
Young,10,"Justice, Supreme Court, Place 6",,REP,Jeff Brown,59,11,8,78
Young,10,"Presiding Judge, Court of Criminal Appeals",,REP,David Bridges,48,14,4,66
Young,10,"Presiding Judge, Court of Criminal Appeals",,REP,Sharon Keller,14,1,5,20
Young,10,"Judge, Court of Criminal Appeals, Place 7",,REP,Barbara Parker Hervey,55,12,8,75
Young,10,"Judge, Court of Criminal Appeals, Place 8",,REP,Jay Brandon,36,7,3,46
Young,10,"Judge, Court of Criminal Appeals, Place 8",,REP,Michelle Slaughter,13,6,6,25
Young,10,"Judge, Court of Criminal Appeals, Place 8",,REP,Dib Waldrip,5,1,0,6
Young,10,State Senator,30,REP,Pat Fallon,40,14,7,61
Young,10,State Senator,30,REP,Craig Carter,13,0,1,14
Young,10,State Senator,30,REP,Craig Estes,25,5,3,33
Young,10,State Representative,68,REP,Drew Springer,64,15,10,89
Young,10,"Chief Justice, 2nd Court of Appeals District",,REP,Bonnie Sudderth,53,11,8,72
Young,10,"Justice, 2nd Court of Appeals District, Place No. 4",,REP,Wade Birdwell,56,12,8,76
Young,10,"Justice, 2nd Court of Appeals District, Place No. 5",,REP,Dabney Bassel,53,12,7,72
Young,10,"Justice, 2nd Court of Appeals District, Place No. 6",,REP,Mark Pittman,56,12,7,75
Young,10,County Judge,,REP,John C. Bullock,64,16,9,89
Young,10,County Judge,,REP,Paul M. Hemphill,20,3,4,27
Young,10,District Clerk,,REP,Jamie Freeze Land,62,13,10,85
Young,10,County Clerk,,REP,Kay Jennings Hardin,62,13,10,85
Young,10,County Treasurer,,REP,Ann B. Daily,63,13,10,86
Young,10,"Justice of the Peace, Precinct No. 3",,REP,Stan G. Mahler,31,7,4,42
Young,10,"Justice of the Peace, Precinct No. 3",,REP,Becky Perez,49,12,9,70
Young,10,"Constable, Precinct No. 3 Unexpired Term",,REP,Cliff Blackstock,44,10,6,60
Young,10,"Constable, Precinct No. 3 Unexpired Term",,REP,Larry Thacker,24,8,5,37
Young,10,County Chairman,,REP,Kyle Zohn Milam,59,12,10,81
Young,10,U.S. Senate,,REP,Edward Kimbrough,2,0,0,2
Young,10,U.S. Senate,,REP,Beto O'Rourke,2,0,0,2
Young,10,U.S. Senate,,REP,Sema Hernandez,0,0,0,0
Young,10,U.S. House,19,DEM,Miguel Levario,3,0,0,3
Young,10,Governor,,DEM,"Cedric Davis, Sr.",1,0,0,1
Young,10,Governor,,DEM,Joe Mumbach,0,0,0,0
Young,10,Governor,,DEM,Jeffrey Payne,0,0,0,0
Young,10,Governor,,DEM,James Jolly Clark,1,0,0,1
Young,10,Governor,,DEM,Grady Yarbrough,0,0,0,0
Young,10,Governor,,DEM,Tom Wakely,0,0,0,0
Young,10,Governor,,DEM,Andrew White,1,0,0,1
Young,10,Governor,,DEM,Adrian Ocegueda,0,0,0,0
Young,10,Governor,,DEM,Lupe Valdez,0,0,0,0
Young,10,Lieutenant Governor,,DEM,Mike Collier,3,0,0,3
Young,10,Lieutenant Governor,,DEM,Michael Cooper,1,0,0,1
Young,10,Attorney General,,DEM,Justin Nelson,3,0,0,3
Young,10,Comptroller of Public Accounts,,DEM,Tim Mahoney,4,0,0,4
Young,10,Comptroller of Public Accounts,,DEM,Joi Chevalier,0,0,0,0
Young,10,Commissioner of the General Land Office,,DEM,Miguel Suazo,0,0,0,0
Young,10,Commissioner of the General Land Office,,DEM,Tex Morgan,3,0,0,3
Young,10,Commissioner of Agriculture,,DEM,Kim Olson,4,0,0,4
Young,10,Railroad Commissioner,,DEM,Roman McAllen,1,0,0,1
Young,10,Railroad Commissioner,,DEM,Chris Spellmon,3,0,0,3
Young,10,"Justice, Supreme Court, Place 2",,DEM,Steven Kirkland,4,0,0,4
Young,10,"Justice, Supreme Court, Place 4",,DEM,R.K. Sandill,4,0,0,4
Young,10,"Justice, Supreme Court, Place 6",,DEM,Kathy Cheng,2,0,0,2
Young,10,"Presiding Judge, Court of Criminal Appeals",,DEM,Maria T. (Terri) Jackson,4,0,0,4
Young,10,"Judge, Court of Criminal Appeals, Place 7",,DEM,Ramona Franklin,2,0,0,2
Young,10,State Senator,30,DEM,Kevin Lopez,3,0,0,3
Young,10,"Justice, 2nd Court of Appeals District, Place No. 5",,DEM,Delonia A. Watson,3,0,0,3
Young,10,County Chairman,,DEM,Fran Edens,2,0,0,2
Young,10,Proposition #1,,DEM,Yes,4,0,0,4
Young,10,Proposition #1,,DEM,No,0,0,0,0
Young,10,Proposition #2,,DEM,Yes,3,0,0,3
Young,10,Proposition #2,,DEM,No,0,0,0,0
Young,10,Proposition #3,,DEM,Yes,3,0,0,3
Young,10,Proposition #3,,DEM,No,0,0,0,0
Young,10,Proposition #4,,DEM,Yes,2,0,0,2
Young,10,Proposition #4,,DEM,No,1,0,0,1
Young,10,Proposition #5,,DEM,Yes,3,0,0,3
Young,10,Proposition #5,,DEM,No,0,0,0,0
Young,10,Proposition #6,,DEM,Yes,3,0,0,3
Young,10,Proposition #6,,DEM,No,0,0,0,0
Young,10,Proposition #7,,DEM,Yes,4,0,0,4
Young,10,Proposition #7,,DEM,No,0,0,0,0
Young,10,Proposition #8,,DEM,Yes,2,0,0,2
Young,10,Proposition #8,,DEM,No,1,0,0,1
Young,10,Proposition #9,,DEM,Yes,3,0,0,3
Young,10,Proposition #9,,DEM,No,1,0,0,1
Young,10,Proposition #10,,DEM,Yes,4,0,0,4
Young,10,Proposition #10,,DEM,No,0,0,0,0
Young,10,Proposition #11,,DEM,Yes,3,0,0,3
Young,10,Proposition #11,,DEM,No,0,0,0,0
Young,10,Proposition #12,,DEM,Yes,3,0,0,3
Young,10,Proposition #12,,DEM,No,0,0,0,0
Young,10,Proposition 1,,DEM,YES,44,6,4,54
Young,10,Proposition 1,,DEM,NO,28,11,7,46
Young,10,Proposition 2,,DEM,YES,80,15,12,107
Young,10,Proposition 2,,DEM,NO,1,1,0,2
Young,10,Proposition 3,,DEM,YES,74,14,9,97
Young,10,Proposition 3,,DEM,NO,3,2,2,7
Young,10,Proposition 4,,DEM,YES,64,15,10,89
Young,10,Proposition 4,,DEM,NO,11,1,1,13
Young,10,Proposition 5,,DEM,YES,55,14,7,76
Young,10,Proposition 5,,DEM,NO,22,2,2,26
Young,10,Proposition 6,,DEM,YES,76,16,10,102
Young,10,Proposition 6,,DEM,NO,6,0,1,7
Young,10,Proposition 7,,DEM,YES,64,12,4,80
Young,10,Proposition 7,,DEM,NO,14,4,5,23
Young,10,Proposition 8,,DEM,YES,77,16,11,104
Young,10,Proposition 8,,DEM,NO,3,0,1,4
Young,10,Proposition 9,,DEM,YES,76,16,6,98
Young,10,Proposition 9,,DEM,NO,3,0,1,4
Young,10,Proposition 10,,DEM,YES,77,16,11,104
Young,10,Proposition 10,,DEM,NO,2,0,1,3
Young,10,Proposition 11,,DEM,YES,72,16,8,96
Young,10,Proposition 11,,DEM,NO,9,0,4,13
Young,16,U.S. Senate,,REP,Ted Cruz,57,3,12,72
Young,16,U.S. Senate,,REP,"Bruce Jacobson, Jr.",0,0,0,0
Young,16,U.S. Senate,,REP,Geraldine Sam,2,0,0,2
Young,16,U.S. Senate,,REP,Stefano de Stefano,0,0,1,1
Young,16,U.S. Senate,,REP,Mary Miller,3,0,0,3
Young,16,U.S. House,19,REP,Jodey Arrington,54,2,11,67
Young,16,Governor,,REP,Greg Abbott,57,3,13,73
Young,16,Governor,,REP,Barbara Krueger,4,0,1,5
Young,16,Governor,,REP,SECEDE Kilgore,0,0,0,0
Young,16,Lieutenant Governor,,REP,Scott Milder,17,0,5,22
Young,16,Lieutenant Governor,,REP,Dan Patrick,40,3,7,50
Young,16,Attorney General,,REP,Ken Paxton,52,3,13,68
Young,16,Comptroller of Public Accounts,,REP,Glenn Hegar,52,3,11,66
Young,16,Commissioner of the General Land Office,,REP,Rick Range,14,0,0,14
Young,16,Commissioner of the General Land Office,,REP,George P. Bush,16,2,8,26
Young,16,Commissioner of the General Land Office,,REP,Jerry Patterson,18,1,3,22
Young,16,Commissioner of the General Land Office,,REP,Davey Edwards,3,0,1,4
Young,16,Commissioner of Agriculture,,REP,Jim Hogan,17,0,3,20
Young,16,Commissioner of Agriculture,,REP,Sid Miller,28,3,7,38
Young,16,Commissioner of Agriculture,,REP,Trey Blocker,10,0,1,11
Young,16,Railroad Commissioner,,REP,Christi Craddick,47,1,11,59
Young,16,Railroad Commissioner,,REP,Weston Martinez,6,2,0,8
Young,16,"Justice, Supreme Court, Place 2",,REP,Jimmy Blacklock,49,3,11,63
Young,16,"Justice, Supreme Court, Place 4",,REP,John Devine,48,3,10,61
Young,16,"Justice, Supreme Court, Place 6",,REP,Jeff Brown,47,3,10,60
Young,16,"Presiding Judge, Court of Criminal Appeals",,REP,David Bridges,29,1,9,39
Young,16,"Presiding Judge, Court of Criminal Appeals",,REP,Sharon Keller,21,2,2,25
Young,16,"Judge, Court of Criminal Appeals, Place 7",,REP,Barbara Parker Hervey,46,3,9,58
Young,16,"Judge, Court of Criminal Appeals, Place 8",,REP,Jay Brandon,25,0,4,29
Young,16,"Judge, Court of Criminal Appeals, Place 8",,REP,Michelle Slaughter,15,1,2,18
Young,16,"Judge, Court of Criminal Appeals, Place 8",,REP,Dib Waldrip,8,2,4,14
Young,16,State Senator,30,REP,Pat Fallon,44,3,14,61
Young,16,State Senator,30,REP,Craig Carter,8,0,0,8
Young,16,State Senator,30,REP,Craig Estes,9,0,0,9
Young,16,State Representative,68,REP,Drew Springer,51,3,11,65
Young,16,"Chief Justice, 2nd Court of Appeals District",,REP,Bonnie Sudderth,47,3,9,59
Young,16,"Justice, 2nd Court of Appeals District, Place No. 4",,REP,Wade Birdwell,48,3,9,60
Young,16,"Justice, 2nd Court of Appeals District, Place No. 5",,REP,Dabney Bassel,46,3,9,58
Young,16,"Justice, 2nd Court of Appeals District, Place No. 6",,REP,Mark Pittman,46,3,9,58
Young,16,County Judge,,REP,John C. Bullock,38,3,10,51
Young,16,County Judge,,REP,Paul M. Hemphill,22,0,4,26
Young,16,District Clerk,,REP,Jamie Freeze Land,50,3,10,63
Young,16,County Clerk,,REP,Kay Jennings Hardin,54,3,12,69
Young,16,County Treasurer,,REP,Ann B. Daily,55,3,10,68
Young,16,"County Commissioner, Precinct No. 4",,REP,Jimmy Ray Wiley,56,3,14,73
Young,16,"Justice of the Peace, Precinct No. 3",,REP,Stan G. Mahler,42,3,12,57
Young,16,"Justice of the Peace, Precinct No. 3",,REP,Becky Perez,15,0,2,17
Young,16,"Constable, Precinct No. 3 Unexpired Term",,REP,Cliff Blackstock,34,2,11,47
Young,16,"Constable, Precinct No. 3 Unexpired Term",,REP,Larry Thacker,20,1,2,23
Young,16,County Chairman,,REP,Kyle Zohn Milam,55,2,12,69
Young,16,U.S. Senate,,DEM,Edward Kimbrough,0,0,0,0
Young,16,U.S. Senate,,DEM,Beto O'Rourke,0,0,0,0
Young,16,U.S. Senate,,DEM,Sema Hernandez,1,0,0,1
Young,16,U.S. House,19,DEM,Miguel Levario,0,0,0,0
Young,16,Governor,,DEM,"Cedric Davis, Sr.",0,0,0,0
Young,16,Governor,,DEM,Joe Mumbach,0,0,0,0
Young,16,Governor,,DEM,Jeffrey Payne,0,0,0,0
Young,16,Governor,,DEM,James Jolly Clark,0,0,0,0
Young,16,Governor,,DEM,Grady Yarbrough,0,0,0,0
Young,16,Governor,,DEM,Tom Wakely,0,0,0,0
Young,16,Governor,,DEM,Andrew White,0,0,0,0
Young,16,Governor,,DEM,Adrian Ocegueda,0,0,0,0
Young,16,Governor,,DEM,Lupe Valdez,0,0,0,0
Young,16,Lieutenant Governor,,DEM,Mike Collier,0,0,0,0
Young,16,Lieutenant Governor,,DEM,Michael Cooper,1,0,0,1
Young,16,Attorney General,,DEM,Justin Nelson,0,0,0,0
Young,16,Comptroller of Public Accounts,,DEM,Tim Mahoney,0,0,0,0
Young,16,Comptroller of Public Accounts,,DEM,Joi Chevalier,0,0,0,0
Young,16,Commissioner of the General Land Office,,DEM,Miguel Suazo,0,0,0,0
Young,16,Commissioner of the General Land Office,,DEM,Tex Morgan,1,0,0,1
Young,16,Commissioner of Agriculture,,DEM,Kim Olson,0,0,0,0
Young,16,Railroad Commissioner,,DEM,Roman McAllen,0,0,0,0
Young,16,Railroad Commissioner,,DEM,Chris Spellmon,0,0,0,0
Young,16,"Justice, Supreme Court, Place 2",,DEM,Steven Kirkland,0,0,0,0
Young,16,"Justice, Supreme Court, Place 4",,DEM,R.K. Sandill,0,0,0,0
Young,16,"Justice, Supreme Court, Place 6",,DEM,Kathy Cheng,0,0,0,0
Young,16,"Presiding Judge, Court of Criminal Appeals",,DEM,Maria T. (Terri) Jackson,0,0,0,0
Young,16,"Judge, Court of Criminal Appeals, Place 7",,DEM,Ramona Franklin,0,0,0,0
Young,16,State Senator,30,DEM,Kevin Lopez,0,0,0,0
Young,16,"Justice, 2nd Court of Appeals District, Place No. 5",,DEM,Delonia A. Watson,0,0,0,0
Young,16,County Chairman,,DEM,Fran Edens,0,0,0,0
Young,16,Proposition #1,,DEM,Yes,0,0,0,0
Young,16,Proposition #1,,DEM,No,1,0,0,1
Young,16,Proposition #2,,DEM,Yes,0,0,0,0
Young,16,Proposition #2,,DEM,No,1,0,0,1
Young,16,Proposition #3,,DEM,Yes,0,0,0,0
Young,16,Proposition #3,,DEM,No,1,0,0,1
Young,16,Proposition #4,,DEM,Yes,0,0,0,0
Young,16,Proposition #4,,DEM,No,1,0,0,1
Young,16,Proposition #5,,DEM,Yes,0,0,0,0
Young,16,Proposition #5,,DEM,No,1,0,0,1
Young,16,Proposition #6,,DEM,Yes,1,0,0,1
Young,16,Proposition #6,,DEM,No,0,0,0,0
Young,16,Proposition #7,,DEM,Yes,1,0,0,1
Young,16,Proposition #7,,DEM,No,0,0,0,0
Young,16,Proposition #8,,DEM,Yes,0,0,0,0
Young,16,Proposition #8,,DEM,No,1,0,0,1
Young,16,Proposition #9,,DEM,Yes,0,0,0,0
Young,16,Proposition #9,,DEM,No,1,0,0,1
Young,16,Proposition #10,,DEM,Yes,1,0,0,1
Young,16,Proposition #10,,DEM,No,0,0,0,0
Young,16,Proposition #11,,DEM,Yes,0,0,0,0
Young,16,Proposition #11,,DEM,No,1,0,0,1
Young,16,Proposition #12,,DEM,Yes,1,0,0,1
Young,16,Proposition #12,,DEM,No,0,0,0,0
Young,16,Proposition 1,,DEM,YES,34,3,6,43
Young,16,Proposition 1,,DEM,NO,19,0,6,25
Young,16,Proposition 2,,DEM,YES,53,3,8,64
Young,16,Proposition 2,,DEM,NO,6,0,5,11
Young,16,Proposition 3,,DEM,YES,59,3,12,74
Young,16,Proposition 3,,DEM,NO,2,0,1,3
Young,16,Proposition 4,,DEM,YES,53,3,10,66
Young,16,Proposition 4,,DEM,NO,5,0,2,7
Young,16,Proposition 5,,DEM,YES,52,3,10,65
Young,16,Proposition 5,,DEM,NO,6,0,3,9
Young,16,Proposition 6,,DEM,YES,56,3,11,70
Young,16,Proposition 6,,DEM,NO,1,0,2,3
Young,16,Proposition 7,,DEM,YES,42,2,8,52
Young,16,Proposition 7,,DEM,NO,14,1,4,19
Young,16,Proposition 8,,DEM,YES,60,3,12,75
Young,16,Proposition 8,,DEM,NO,0,0,0,0
Young,16,Proposition 9,,DEM,YES,60,3,13,76
Young,16,Proposition 9,,DEM,NO,1,0,0,1
Young,16,Proposition 10,,DEM,YES,52,3,9,64
Young,16,Proposition 10,,DEM,NO,7,0,4,11
Young,16,Proposition 11,,DEM,YES,54,3,7,64
Young,16,Proposition 11,,DEM,NO,6,0,5,11
Young,20,U.S. Senate,,REP,Ted Cruz,15,3,17,35
Young,20,U.S. Senate,,REP,"Bruce Jacobson, Jr.",1,0,1,2
Young,20,U.S. Senate,,REP,Geraldine Sam,0,0,0,0
Young,20,U.S. Senate,,REP,Stefano de Stefano,0,0,1,1
Young,20,U.S. Senate,,REP,Mary Miller,0,0,0,0
Young,20,U.S. House,19,REP,Jodey Arrington,15,2,17,34
Young,20,Governor,,REP,Greg Abbott,15,3,16,34
Young,20,Governor,,REP,Barbara Krueger,0,0,3,3
Young,20,Governor,,REP,SECEDE Kilgore,0,0,0,0
Young,20,Lieutenant Governor,,REP,Scott Milder,2,1,2,5
Young,20,Lieutenant Governor,,REP,Dan Patrick,14,2,15,31
Young,20,Attorney General,,REP,Ken Paxton,15,2,18,35
Young,20,Comptroller of Public Accounts,,REP,Glenn Hegar,13,2,17,32
Young,20,Commissioner of the General Land Office,,REP,Rick Range,2,0,4,6
Young,20,Commissioner of the General Land Office,,REP,George P. Bush,7,2,8,17
Young,20,Commissioner of the General Land Office,,REP,Jerry Patterson,5,0,3,8
Young,20,Commissioner of the General Land Office,,REP,Davey Edwards,1,1,0,2
Young,20,Commissioner of Agriculture,,REP,Jim Hogan,3,1,2,6
Young,20,Commissioner of Agriculture,,REP,Sid Miller,9,2,11,22
Young,20,Commissioner of Agriculture,,REP,Trey Blocker,1,0,1,2
Young,20,Railroad Commissioner,,REP,Christi Craddick,12,3,10,25
Young,20,Railroad Commissioner,,REP,Weston Martinez,3,0,5,8
Young,20,"Justice, Supreme Court, Place 2",,REP,Jimmy Blacklock,14,2,13,29
Young,20,"Justice, Supreme Court, Place 4",,REP,John Devine,14,2,13,29
Young,20,"Justice, Supreme Court, Place 6",,REP,Jeff Brown,14,2,13,29
Young,20,"Presiding Judge, Court of Criminal Appeals",,REP,David Bridges,8,3,9,20
Young,20,"Presiding Judge, Court of Criminal Appeals",,REP,Sharon Keller,5,0,3,8
Young,20,"Judge, Court of Criminal Appeals, Place 7",,REP,Barbara Parker Hervey,12,2,13,27
Young,20,"Judge, Court of Criminal Appeals, Place 8",,REP,Jay Brandon,7,1,9,17
Young,20,"Judge, Court of Criminal Appeals, Place 8",,REP,Michelle Slaughter,3,2,2,7
Young,20,"Judge, Court of Criminal Appeals, Place 8",,REP,Dib Waldrip,3,0,2,5
Young,20,State Senator,30,REP,Pat Fallon,8,3,9,20
Young,20,State Senator,30,REP,Craig Carter,5,0,6,11
Young,20,State Senator,30,REP,Craig Estes,3,0,3,6
Young,20,State Representative,68,REP,Drew Springer,15,2,15,32
Young,20,"Chief Justice, 2nd Court of Appeals District",,REP,Bonnie Sudderth,12,2,13,27
Young,20,"Justice, 2nd Court of Appeals District, Place No. 4",,REP,Wade Birdwell,12,2,13,27
Young,20,"Justice, 2nd Court of Appeals District, Place No. 5",,REP,Dabney Bassel,12,2,13,27
Young,20,"Justice, 2nd Court of Appeals District, Place No. 6",,REP,Mark Pittman,12,2,12,26
Young,20,County Judge,,REP,John C. Bullock,7,3,15,25
Young,20,County Judge,,REP,Paul M. Hemphill,9,0,5,14
Young,20,District Clerk,,REP,Jamie Freeze Land,13,2,14,29
Young,20,County Clerk,,REP,Kay Jennings Hardin,14,2,14,30
Young,20,County Treasurer,,REP,Ann B. Daily,13,2,14,29
Young,20,"County Commissioner, Precinct No. 4",,REP,Jimmy Ray Wiley,12,2,17,31
Young,20,"Justice of the Peace, Precinct No. 3",,REP,Stan G. Mahler,13,0,11,24
Young,20,"Justice of the Peace, Precinct No. 3",,REP,Becky Perez,2,3,8,13
Young,20,"Constable, Precinct No. 3 Unexpired Term",,REP,Cliff Blackstock,6,2,8,16
Young,20,"Constable, Precinct No. 3 Unexpired Term",,REP,Larry Thacker,6,1,6,13
Young,20,County Chairman,,REP,Kyle Zohn Milam,13,2,15,30
Young,20,U.S. Senate,,DEM,Edward Kimbrough,0,2,0,2
Young,20,U.S. Senate,,DEM,Beto O'Rourke,2,1,0,3
Young,20,U.S. Senate,,DEM,Sema Hernandez,0,0,0,0
Young,20,U.S. House,19,DEM,Miguel Levario,2,3,0,5
Young,20,Governor,,DEM,"Cedric Davis, Sr.",1,0,0,1
Young,20,Governor,,DEM,Joe Mumbach,0,0,0,0
Young,20,Governor,,DEM,Jeffrey Payne,0,2,0,2
Young,20,Governor,,DEM,James Jolly Clark,0,0,0,0
Young,20,Governor,,DEM,Grady Yarbrough,0,0,0,0
Young,20,Governor,,DEM,Tom Wakely,1,1,0,2
Young,20,Governor,,DEM,Andrew White,0,0,0,0
Young,20,Governor,,DEM,Adrian Ocegueda,0,0,0,0
Young,20,Governor,,DEM,Lupe Valdez,0,0,0,0
Young,20,Lieutenant Governor,,DEM,Mike Collier,2,1,0,3
Young,20,Lieutenant Governor,,DEM,Michael Cooper,0,2,0,2
Young,20,Attorney General,,DEM,Justin Nelson,2,3,0,5
Young,20,Comptroller of Public Accounts,,DEM,Tim Mahoney,1,2,0,3
Young,20,Comptroller of Public Accounts,,DEM,Joi Chevalier,1,1,0,2
Young,20,Commissioner of the General Land Office,,DEM,Miguel Suazo,2,0,0,2
Young,20,Commissioner of the General Land Office,,DEM,Tex Morgan,0,3,0,3
Young,20,Commissioner of Agriculture,,DEM,Kim Olson,2,3,0,5
Young,20,Railroad Commissioner,,DEM,Roman McAllen,2,0,0,2
Young,20,Railroad Commissioner,,DEM,Chris Spellmon,0,3,0,3
Young,20,"Justice, Supreme Court, Place 2",,DEM,Steven Kirkland,2,3,0,5
Young,20,"Justice, Supreme Court, Place 4",,DEM,R.K. Sandill,2,3,0,5
Young,20,"Justice, Supreme Court, Place 6",,DEM,Kathy Cheng,2,3,0,5
Young,20,"Presiding Judge, Court of Criminal Appeals",,DEM,Maria T. (Terri) Jackson,2,3,0,5
Young,20,"Judge, Court of Criminal Appeals, Place 7",,DEM,Ramona Franklin,2,3,0,5
Young,20,State Senator,30,DEM,Kevin Lopez,2,3,0,5
Young,20,"Justice, 2nd Court of Appeals District, Place No. 5",,DEM,Delonia A. Watson,2,3,0,5
Young,20,County Chairman,,DEM,Fran Edens,2,3,0,5
Young,20,Proposition #1,,DEM,Yes,2,3,0,5
Young,20,Proposition #1,,DEM,No,0,0,0,0
Young,20,Proposition #2,,DEM,Yes,2,2,0,4
Young,20,Proposition #2,,DEM,No,0,1,0,1
Young,20,Proposition #3,,DEM,Yes,2,2,0,4
Young,20,Proposition #3,,DEM,No,0,1,0,1
Young,20,Proposition #4,,DEM,Yes,2,3,0,5
Young,20,Proposition #4,,DEM,No,0,0,0,0
Young,20,Proposition #5,,DEM,Yes,2,3,0,5
Young,20,Proposition #5,,DEM,No,0,0,0,0
Young,20,Proposition #6,,DEM,Yes,2,3,0,5
Young,20,Proposition #6,,DEM,No,0,0,0,0
Young,20,Proposition #7,,DEM,Yes,2,2,0,4
Young,20,Proposition #7,,DEM,No,0,1,0,1
Young,20,Proposition #8,,DEM,Yes,2,3,0,5
Young,20,Proposition #8,,DEM,No,0,0,0,0
Young,20,Proposition #9,,DEM,Yes,2,3,0,5
Young,20,Proposition #9,,DEM,No,0,0,0,0
Young,20,Proposition #10,,DEM,Yes,2,3,0,5
Young,20,Proposition #10,,DEM,No,0,0,0,0
Young,20,Proposition #11,,DEM,Yes,2,3,0,5
Young,20,Proposition #11,,DEM,No,0,0,0,0
Young,20,Proposition #12,,DEM,Yes,2,3,0,5
Young,20,Proposition #12,,DEM,No,0,0,0,0
Young,20,Proposition 1,,DEM,YES,9,2,14,25
Young,20,Proposition 1,,DEM,NO,5,0,3,8
Young,20,Proposition 2,,DEM,YES,12,3,16,31
Young,20,Proposition 2,,DEM,NO,4,0,1,5
Young,20,Proposition 3,,DEM,YES,14,3,17,34
Young,20,Proposition 3,,DEM,NO,2,0,1,3
Young,20,Proposition 4,,DEM,YES,13,3,14,30
Young,20,Proposition 4,,DEM,NO,3,0,3,6
Young,20,Proposition 5,,DEM,YES,13,3,15,31
Young,20,Proposition 5,,DEM,NO,3,0,2,5
Young,20,Proposition 6,,DEM,YES,14,3,17,34
Young,20,Proposition 6,,DEM,NO,2,0,2,4
Young,20,Proposition 7,,DEM,YES,11,3,15,29
Young,20,Proposition 7,,DEM,NO,4,0,4,8
Young,20,Proposition 8,,DEM,YES,15,3,18,36
Young,20,Proposition 8,,DEM,NO,1,0,1,2
Young,20,Proposition 9,,DEM,YES,16,3,18,37
Young,20,Proposition 9,,DEM,NO,0,0,1,1
Young,20,Proposition 10,,DEM,YES,12,3,18,33
Young,20,Proposition 10,,DEM,NO,2,0,0,2
Young,20,Proposition 11,,DEM,YES,13,3,17,33
Young,20,Proposition 11,,DEM,NO,2,0,1,3
Young,22,U.S. Senate,,REP,Ted Cruz,319,115,322,756
Young,22,U.S. Senate,,REP,"Bruce Jacobson, Jr.",4,12,14,30
Young,22,U.S. Senate,,REP,Geraldine Sam,2,3,3,8
Young,22,U.S. Senate,,REP,Stefano de Stefano,0,0,7,7
Young,22,U.S. Senate,,REP,Mary Miller,14,4,18,36
Young,22,U.S. House,19,REP,Jodey Arrington,305,119,316,740
Young,22,Governor,,REP,Greg Abbott,318,129,328,775
Young,22,Governor,,REP,Barbara Krueger,16,5,26,47
Young,22,Governor,,REP,SECEDE Kilgore,0,0,10,10
Young,22,Lieutenant Governor,,REP,Scott Milder,103,20,118,241
Young,22,Lieutenant Governor,,REP,Dan Patrick,224,107,235,566
Young,22,Attorney General,,REP,Ken Paxton,301,116,315,732
Young,22,Comptroller of Public Accounts,,REP,Glenn Hegar,285,120,294,699
Young,22,Commissioner of the General Land Office,,REP,Rick Range,30,9,33,72
Young,22,Commissioner of the General Land Office,,REP,George P. Bush,183,60,212,455
Young,22,Commissioner of the General Land Office,,REP,Jerry Patterson,90,33,66,189
Young,22,Commissioner of the General Land Office,,REP,Davey Edwards,10,17,26,53
Young,22,Commissioner of Agriculture,,REP,Jim Hogan,74,39,85,198
Young,22,Commissioner of Agriculture,,REP,Sid Miller,170,54,164,388
Young,22,Commissioner of Agriculture,,REP,Trey Blocker,45,24,56,125
Young,22,Railroad Commissioner,,REP,Christi Craddick,221,90,240,551
Young,22,Railroad Commissioner,,REP,Weston Martinez,66,28,59,153
Young,22,"Justice, Supreme Court, Place 2",,REP,Jimmy Blacklock,274,111,281,666
Young,22,"Justice, Supreme Court, Place 4",,REP,John Devine,273,110,278,661
Young,22,"Justice, Supreme Court, Place 6",,REP,Jeff Brown,270,110,274,654
Young,22,"Presiding Judge, Court of Criminal Appeals",,REP,David Bridges,196,68,190,454
Young,22,"Presiding Judge, Court of Criminal Appeals",,REP,Sharon Keller,87,46,104,237
Young,22,"Judge, Court of Criminal Appeals, Place 7",,REP,Barbara Parker Hervey,267,108,270,645
Young,22,"Judge, Court of Criminal Appeals, Place 8",,REP,Jay Brandon,128,51,117,296
Young,22,"Judge, Court of Criminal Appeals, Place 8",,REP,Michelle Slaughter,105,42,111,258
Young,22,"Judge, Court of Criminal Appeals, Place 8",,REP,Dib Waldrip,35,19,42,96
Young,22,State Senator,30,REP,Pat Fallon,196,85,233,514
Young,22,State Senator,30,REP,Craig Carter,55,15,58,128
Young,22,State Senator,30,REP,Craig Estes,79,31,72,182
Young,22,State Representative,68,REP,Drew Springer,298,120,304,722
Young,22,"Chief Justice, 2nd Court of Appeals District",,REP,Bonnie Sudderth,267,110,272,649
Young,22,"Justice, 2nd Court of Appeals District, Place No. 4",,REP,Wade Birdwell,271,112,272,655
Young,22,"Justice, 2nd Court of Appeals District, Place No. 5",,REP,Dabney Bassel,269,109,274,652
Young,22,"Justice, 2nd Court of Appeals District, Place No. 6",,REP,Mark Pittman,265,111,270,646
Young,22,County Judge,,REP,John C. Bullock,225,91,240,556
Young,22,County Judge,,REP,Paul M. Hemphill,114,39,125,278
Young,22,District Clerk,,REP,Jamie Freeze Land,296,112,304,712
Young,22,County Clerk,,REP,Kay Jennings Hardin,291,114,308,713
Young,22,County Treasurer,,REP,Ann B. Daily,292,115,310,717
Young,22,"Justice of the Peace, Precinct No. 1",,REP,Jason Hearne,116,36,150,302
Young,22,"Justice of the Peace, Precinct No. 1",,REP,Randy Saylor,94,32,77,203
Young,22,"Justice of the Peace, Precinct No. 1",,REP,Norman B. Carpenter,66,37,82,185
Young,22,"Justice of the Peace, Precinct No. 1",,REP,Jabe Underwood,62,24,60,146
Young,22,County Chairman,,REP,Kyle Zohn Milam,297,113,315,725
Young,22,U.S. Senate,,DEM,Edward Kimbrough,2,7,2,11
Young,22,U.S. Senate,,DEM,Beto O'Rourke,6,6,12,24
Young,22,U.S. Senate,,DEM,Sema Hernandez,5,1,0,6
Young,22,U.S. House,19,DEM,Miguel Levario,13,11,11,35
Young,22,Governor,,DEM,"Cedric Davis, Sr.",0,0,1,1
Young,22,Governor,,DEM,Joe Mumbach,0,0,1,1
Young,22,Governor,,DEM,Jeffrey Payne,0,1,0,1
Young,22,Governor,,DEM,James Jolly Clark,0,0,0,0
Young,22,Governor,,DEM,Grady Yarbrough,2,2,2,6
Young,22,Governor,,DEM,Tom Wakely,3,0,1,4
Young,22,Governor,,DEM,Andrew White,1,5,5,11
Young,22,Governor,,DEM,Adrian Ocegueda,1,2,1,4
Young,22,Governor,,DEM,Lupe Valdez,5,4,3,12
Young,22,Lieutenant Governor,,DEM,Mike Collier,8,7,8,23
Young,22,Lieutenant Governor,,DEM,Michael Cooper,5,7,3,15
Young,22,Attorney General,,DEM,Justin Nelson,13,13,13,39
Young,22,Comptroller of Public Accounts,,DEM,Tim Mahoney,8,8,5,21
Young,22,Comptroller of Public Accounts,,DEM,Joi Chevalier,4,6,6,16
Young,22,Commissioner of the General Land Office,,DEM,Miguel Suazo,10,8,6,24
Young,22,Commissioner of the General Land Office,,DEM,Tex Morgan,2,6,6,14
Young,22,Commissioner of Agriculture,,DEM,Kim Olson,12,12,12,36
Young,22,Railroad Commissioner,,DEM,Roman McAllen,6,7,7,20
Young,22,Railroad Commissioner,,DEM,Chris Spellmon,6,7,5,18
Young,22,"Justice, Supreme Court, Place 2",,DEM,Steven Kirkland,11,12,12,35
Young,22,"Justice, Supreme Court, Place 4",,DEM,R.K. Sandill,12,12,13,37
Young,22,"Justice, Supreme Court, Place 6",,DEM,Kathy Cheng,12,12,13,37
Young,22,"Presiding Judge, Court of Criminal Appeals",,DEM,Maria T. (Terri) Jackson,12,12,13,37
Young,22,"Judge, Court of Criminal Appeals, Place 7",,DEM,Ramona Franklin,12,12,13,37
Young,22,State Senator,30,DEM,Kevin Lopez,11,11,14,36
Young,22,"Justice, 2nd Court of Appeals District, Place No. 5",,DEM,Delonia A. Watson,12,12,14,38
Young,22,County Chairman,,DEM,Fran Edens,12,12,14,38
Young,22,Proposition #1,,DEM,Yes,13,12,14,39
Young,22,Proposition #1,,DEM,No,0,2,1,3
Young,22,Proposition #2,,DEM,Yes,13,12,15,40
Young,22,Proposition #2,,DEM,No,0,2,0,2
Young,22,Proposition #3,,DEM,Yes,12,11,12,35
Young,22,Proposition #3,,DEM,No,0,3,3,6
Young,22,Proposition #4,,DEM,Yes,13,14,14,41
Young,22,Proposition #4,,DEM,No,0,0,0,0
Young,22,Proposition #5,,DEM,Yes,12,13,13,38
Young,22,Proposition #5,,DEM,No,1,1,0,2
Young,22,Proposition #6,,DEM,Yes,13,14,14,41
Young,22,Proposition #6,,DEM,No,0,0,0,0
Young,22,Proposition #7,,DEM,Yes,12,13,12,37
Young,22,Proposition #7,,DEM,No,0,1,2,3
Young,22,Proposition #8,,DEM,Yes,12,10,13,35
Young,22,Proposition #8,,DEM,No,0,4,1,5
Young,22,Proposition #9,,DEM,Yes,13,13,13,39
Young,22,Proposition #9,,DEM,No,0,1,1,2
Young,22,Proposition #10,,DEM,Yes,13,13,13,39
Young,22,Proposition #10,,DEM,No,0,0,1,1
Young,22,Proposition #11,,DEM,Yes,12,11,12,35
Young,22,Proposition #11,,DEM,No,1,3,1,5
Young,22,Proposition #12,,DEM,Yes,13,14,14,41
Young,22,Proposition #12,,DEM,No,0,0,0,0
Young,22,Proposition 1,,DEM,YES,230,80,230,540
Young,22,Proposition 1,,DEM,NO,97,42,117,256
Young,22,Proposition 2,,DEM,YES,305,125,339,769
Young,22,Proposition 2,,DEM,NO,32,5,28,65
Young,22,Proposition 3,,DEM,YES,296,116,321,733
Young,22,Proposition 3,,DEM,NO,29,14,46,89
Young,22,Proposition 4,,DEM,YES,308,124,324,756
Young,22,Proposition 4,,DEM,NO,30,7,41,78
Young,22,Proposition 5,,DEM,YES,269,112,272,653
Young,22,Proposition 5,,DEM,NO,73,18,96,187
Young,22,Proposition 6,,DEM,YES,330,129,344,803
Young,22,Proposition 6,,DEM,NO,11,5,23,39
Young,22,Proposition 7,,DEM,YES,264,103,284,651
Young,22,Proposition 7,,DEM,NO,82,27,84,193
Young,22,Proposition 8,,DEM,YES,338,129,357,824
Young,22,Proposition 8,,DEM,NO,9,4,15,28
Young,22,Proposition 9,,DEM,YES,316,120,345,781
Young,22,Proposition 9,,DEM,NO,25,11,23,59
Young,22,Proposition 10,,DEM,YES,323,123,343,789
Young,22,Proposition 10,,DEM,NO,13,6,22,41
Young,22,Proposition 11,,DEM,YES,301,119,321,741
Young,22,Proposition 11,,DEM,NO,43,11,46,100
Young,23,U.S. Senate,,REP,Ted Cruz,200,59,209,468
Young,23,U.S. Senate,,REP,"Bruce Jacobson, Jr.",13,5,10,28
Young,23,U.S. Senate,,REP,Geraldine Sam,2,1,1,4
Young,23,U.S. Senate,,REP,Stefano de Stefano,5,0,6,11
Young,23,U.S. Senate,,REP,Mary Miller,4,0,13,17
Young,23,U.S. House,19,REP,Jodey Arrington,198,53,213,464
Young,23,Governor,,REP,Greg Abbott,200,62,200,462
Young,23,Governor,,REP,Barbara Krueger,16,4,31,51
Young,23,Governor,,REP,SECEDE Kilgore,5,1,2,8
Young,23,Lieutenant Governor,,REP,Scott Milder,89,17,109,215
Young,23,Lieutenant Governor,,REP,Dan Patrick,125,43,125,293
Young,23,Attorney General,,REP,Ken Paxton,191,55,206,452
Young,23,Comptroller of Public Accounts,,REP,Glenn Hegar,179,52,203,434
Young,23,Commissioner of the General Land Office,,REP,Rick Range,26,11,32,69
Young,23,Commissioner of the General Land Office,,REP,George P. Bush,136,42,138,316
Young,23,Commissioner of the General Land Office,,REP,Jerry Patterson,35,6,44,85
Young,23,Commissioner of the General Land Office,,REP,Davey Edwards,9,2,12,23
Young,23,Commissioner of Agriculture,,REP,Jim Hogan,56,19,68,143
Young,23,Commissioner of Agriculture,,REP,Sid Miller,106,26,117,249
Young,23,Commissioner of Agriculture,,REP,Trey Blocker,26,10,29,65
Young,23,Railroad Commissioner,,REP,Christi Craddick,134,45,156,335
Young,23,Railroad Commissioner,,REP,Weston Martinez,49,12,51,112
Young,23,"Justice, Supreme Court, Place 2",,REP,Jimmy Blacklock,182,46,206,434
Young,23,"Justice, Supreme Court, Place 4",,REP,John Devine,177,45,195,417
Young,23,"Justice, Supreme Court, Place 6",,REP,Jeff Brown,175,48,194,417
Young,23,"Presiding Judge, Court of Criminal Appeals",,REP,David Bridges,122,36,128,286
Young,23,"Presiding Judge, Court of Criminal Appeals",,REP,Sharon Keller,49,18,76,143
Young,23,"Judge, Court of Criminal Appeals, Place 7",,REP,Barbara Parker Hervey,174,46,193,413
Young,23,"Judge, Court of Criminal Appeals, Place 8",,REP,Jay Brandon,79,33,107,219
Young,23,"Judge, Court of Criminal Appeals, Place 8",,REP,Michelle Slaughter,53,12,70,135
Young,23,"Judge, Court of Criminal Appeals, Place 8",,REP,Dib Waldrip,32,6,27,65
Young,23,State Senator,30,REP,Pat Fallon,146,51,129,326
Young,23,State Senator,30,REP,Craig Carter,39,4,38,81
Young,23,State Senator,30,REP,Craig Estes,43,13,77,133
Young,23,State Representative,68,REP,Drew Springer,202,51,214,467
Young,23,"Chief Justice, 2nd Court of Appeals District",,REP,Bonnie Sudderth,177,44,196,417
Young,23,"Justice, 2nd Court of Appeals District, Place No. 4",,REP,Wade Birdwell,176,44,195,415
Young,23,"Justice, 2nd Court of Appeals District, Place No. 5",,REP,Dabney Bassel,176,44,190,410
Young,23,"Justice, 2nd Court of Appeals District, Place No. 6",,REP,Mark Pittman,176,44,191,411
Young,23,County Judge,,REP,John C. Bullock,181,53,176,410
Young,23,County Judge,,REP,Paul M. Hemphill,47,13,67,127
Young,23,District Clerk,,REP,Jamie Freeze Land,188,49,201,438
Young,23,County Clerk,,REP,Kay Jennings Hardin,191,49,208,448
Young,23,County Treasurer,,REP,Ann B. Daily,191,52,202,445
Young,23,"Justice of the Peace, Precinct No. 3",,REP,Stan G. Mahler,149,47,174,370
Young,23,"Justice of the Peace, Precinct No. 3",,REP,Becky Perez,81,20,76,177
Young,23,"Constable, Precinct No. 3 Unexpired Term",,REP,Cliff Blackstock,141,38,154,333
Young,23,"Constable, Precinct No. 3 Unexpired Term",,REP,Larry Thacker,79,22,80,181
Young,23,County Chairman,,REP,Kyle Zohn Milam,184,47,197,428
Young,23,U.S. Senate,,DEM,Edward Kimbrough,2,8,5,15
Young,23,U.S. Senate,,DEM,Beto O'Rourke,11,4,5,20
Young,23,U.S. Senate,,DEM,Sema Hernandez,4,6,1,11
Young,23,U.S. House,19,DEM,Miguel Levario,14,16,8,38
Young,23,Governor,,DEM,"Cedric Davis, Sr.",4,0,1,5
Young,23,Governor,,DEM,Joe Mumbach,0,0,0,0
Young,23,Governor,,DEM,Jeffrey Payne,0,1,1,2
Young,23,Governor,,DEM,James Jolly Clark,1,0,0,1
Young,23,Governor,,DEM,Grady Yarbrough,1,6,2,9
Young,23,Governor,,DEM,Tom Wakely,1,0,0,1
Young,23,Governor,,DEM,Andrew White,4,7,2,13
Young,23,Governor,,DEM,Adrian Ocegueda,1,2,0,3
Young,23,Governor,,DEM,Lupe Valdez,5,1,3,9
Young,23,Lieutenant Governor,,DEM,Mike Collier,10,9,7,26
Young,23,Lieutenant Governor,,DEM,Michael Cooper,6,8,2,16
Young,23,Attorney General,,DEM,Justin Nelson,13,16,7,36
Young,23,Comptroller of Public Accounts,,DEM,Tim Mahoney,11,11,10,32
Young,23,Comptroller of Public Accounts,,DEM,Joi Chevalier,4,7,1,12
Young,23,Commissioner of the General Land Office,,DEM,Miguel Suazo,8,3,6,17
Young,23,Commissioner of the General Land Office,,DEM,Tex Morgan,7,14,4,25
Young,23,Commissioner of Agriculture,,DEM,Kim Olson,13,17,10,40
Young,23,Railroad Commissioner,,DEM,Roman McAllen,7,9,8,24
Young,23,Railroad Commissioner,,DEM,Chris Spellmon,8,8,3,19
Young,23,"Justice, Supreme Court, Place 2",,DEM,Steven Kirkland,14,16,8,38
Young,23,"Justice, Supreme Court, Place 4",,DEM,R.K. Sandill,13,16,8,37
Young,23,"Justice, Supreme Court, Place 6",,DEM,Kathy Cheng,13,16,8,37
Young,23,"Presiding Judge, Court of Criminal Appeals",,DEM,Maria T. (Terri) Jackson,14,15,7,36
Young,23,"Judge, Court of Criminal Appeals, Place 7",,DEM,Ramona Franklin,13,16,7,36
Young,23,State Senator,30,DEM,Kevin Lopez,14,16,8,38
Young,23,"Justice, 2nd Court of Appeals District, Place No. 5",,DEM,Delonia A. Watson,13,16,8,37
Young,23,County Chairman,,DEM,Fran Edens,12,16,7,35
Young,23,Proposition #1,,DEM,Yes,16,21,12,49
Young,23,Proposition #1,,DEM,No,1,0,0,1
Young,23,Proposition #2,,DEM,Yes,16,18,12,46
Young,23,Proposition #2,,DEM,No,2,1,0,3
Young,23,Proposition #3,,DEM,Yes,17,18,12,47
Young,23,Proposition #3,,DEM,No,1,2,0,3
Young,23,Proposition #4,,DEM,Yes,17,19,12,48
Young,23,Proposition #4,,DEM,No,1,0,0,1
Young,23,Proposition #5,,DEM,Yes,14,16,11,41
Young,23,Proposition #5,,DEM,No,2,3,1,6
Young,23,Proposition #6,,DEM,Yes,17,21,12,50
Young,23,Proposition #6,,DEM,No,1,0,0,1
Young,23,Proposition #7,,DEM,Yes,17,21,12,50
Young,23,Proposition #7,,DEM,No,1,0,0,1
Young,23,Proposition #8,,DEM,Yes,14,17,9,40
Young,23,Proposition #8,,DEM,No,3,3,3,9
Young,23,Proposition #9,,DEM,Yes,16,19,10,45
Young,23,Proposition #9,,DEM,No,1,1,1,3
Young,23,Proposition #10,,DEM,Yes,17,20,12,49
Young,23,Proposition #10,,DEM,No,1,1,0,2
Young,23,Proposition #11,,DEM,Yes,18,20,12,50
Young,23,Proposition #11,,DEM,No,1,0,0,1
Young,23,Proposition #12,,DEM,Yes,17,21,11,49
Young,23,Proposition #12,,DEM,No,1,0,1,2
Young,23,Proposition 1,,DEM,YES,141,37,131,309
Young,23,Proposition 1,,DEM,NO,66,21,93,180
Young,23,Proposition 2,,DEM,YES,199,57,208,464
Young,23,Proposition 2,,DEM,NO,21,6,25,52
Young,23,Proposition 3,,DEM,YES,192,63,197,452
Young,23,Proposition 3,,DEM,NO,26,3,38,67
Young,23,Proposition 4,,DEM,YES,200,59,214,473
Young,23,Proposition 4,,DEM,NO,19,2,17,38
Young,23,Proposition 5,,DEM,YES,151,47,150,348
Young,23,Proposition 5,,DEM,NO,68,15,88,171
Young,23,Proposition 6,,DEM,YES,208,66,217,491
Young,23,Proposition 6,,DEM,NO,14,2,25,41
Young,23,Proposition 7,,DEM,YES,161,53,179,393
Young,23,Proposition 7,,DEM,NO,57,11,58,126
Young,23,Proposition 8,,DEM,YES,220,66,229,515
Young,23,Proposition 8,,DEM,NO,5,0,13,18
Young,23,Proposition 9,,DEM,YES,194,62,210,466
Young,23,Proposition 9,,DEM,NO,22,4,35,61
Young,23,Proposition 10,,DEM,YES,201,62,205,468
Young,23,Proposition 10,,DEM,NO,13,2,25,40
Young,23,Proposition 11,,DEM,YES,196,62,205,463
Young,23,Proposition 11,,DEM,NO,26,6,35,67
Young,24,U.S. Senate,,REP,Ted Cruz,91,39,113,243
Young,24,U.S. Senate,,REP,"Bruce Jacobson, Jr.",3,1,5,9
Young,24,U.S. Senate,,REP,Geraldine Sam,0,1,0,1
Young,24,U.S. Senate,,REP,Stefano de Stefano,2,0,4,6
Young,24,U.S. Senate,,REP,Mary Miller,8,2,4,14
Young,24,U.S. House,19,REP,Jodey Arrington,92,42,115,249
Young,24,Governor,,REP,Greg Abbott,90,42,116,248
Young,24,Governor,,REP,Barbara Krueger,10,2,5,17
Young,24,Governor,,REP,SECEDE Kilgore,0,0,0,0
Young,24,Lieutenant Governor,,REP,Scott Milder,23,5,38,66
Young,24,Lieutenant Governor,,REP,Dan Patrick,72,37,84,193
Young,24,Attorney General,,REP,Ken Paxton,90,41,113,244
Young,24,Comptroller of Public Accounts,,REP,Glenn Hegar,87,41,106,234
Young,24,Commissioner of the General Land Office,,REP,Rick Range,6,6,18,30
Young,24,Commissioner of the General Land Office,,REP,George P. Bush,57,24,69,150
Young,24,Commissioner of the General Land Office,,REP,Jerry Patterson,23,10,20,53
Young,24,Commissioner of the General Land Office,,REP,Davey Edwards,8,2,6,16
Young,24,Commissioner of Agriculture,,REP,Jim Hogan,35,18,38,91
Young,24,Commissioner of Agriculture,,REP,Sid Miller,41,17,53,111
Young,24,Commissioner of Agriculture,,REP,Trey Blocker,12,6,17,35
Young,24,Railroad Commissioner,,REP,Christi Craddick,72,38,87,197
Young,24,Railroad Commissioner,,REP,Weston Martinez,17,3,18,38
Young,24,"Justice, Supreme Court, Place 2",,REP,Jimmy Blacklock,82,40,105,227
Young,24,"Justice, Supreme Court, Place 4",,REP,John Devine,80,39,106,225
Young,24,"Justice, Supreme Court, Place 6",,REP,Jeff Brown,79,40,105,224
Young,24,"Presiding Judge, Court of Criminal Appeals",,REP,David Bridges,60,25,65,150
Young,24,"Presiding Judge, Court of Criminal Appeals",,REP,Sharon Keller,28,14,43,85
Young,24,"Judge, Court of Criminal Appeals, Place 7",,REP,Barbara Parker Hervey,82,39,105,226
Young,24,"Judge, Court of Criminal Appeals, Place 8",,REP,Jay Brandon,43,19,41,103
Young,24,"Judge, Court of Criminal Appeals, Place 8",,REP,Michelle Slaughter,28,14,44,86
Young,24,"Judge, Court of Criminal Appeals, Place 8",,REP,Dib Waldrip,13,6,15,34
Young,24,State Senator,30,REP,Pat Fallon,59,35,85,179
Young,24,State Senator,30,REP,Craig Carter,16,2,20,38
Young,24,State Senator,30,REP,Craig Estes,27,7,22,56
Young,24,State Representative,68,REP,Drew Springer,91,41,114,246
Young,24,"Chief Justice, 2nd Court of Appeals District",,REP,Bonnie Sudderth,82,39,103,224
Young,24,"Justice, 2nd Court of Appeals District, Place No. 4",,REP,Wade Birdwell,84,39,100,223
Young,24,"Justice, 2nd Court of Appeals District, Place No. 5",,REP,Dabney Bassel,79,40,100,219
Young,24,"Justice, 2nd Court of Appeals District, Place No. 6",,REP,Mark Pittman,80,38,97,215
Young,24,County Judge,,REP,John C. Bullock,65,36,90,191
Young,24,County Judge,,REP,Paul M. Hemphill,39,9,37,85
Young,24,District Clerk,,REP,Jamie Freeze Land,90,40,107,237
Young,24,County Clerk,,REP,Kay Jennings Hardin,89,40,112,241
Young,24,County Treasurer,,REP,Ann B. Daily,87,41,112,240
Young,24,"County Commissioner, Precinct No. 4",,REP,Jimmy Ray Wiley,92,41,110,243
Young,24,"Justice of the Peace, Precinct No. 1",,REP,Jason Hearne,44,15,42,101
Young,24,"Justice of the Peace, Precinct No. 1",,REP,Randy Saylor,14,12,33,59
Young,24,"Justice of the Peace, Precinct No. 1",,REP,Norman B. Carpenter,21,6,24,51
Young,24,"Justice of the Peace, Precinct No. 1",,REP,Jabe Underwood,23,12,25,60
Young,24,County Chairman,,REP,Kyle Zohn Milam,88,40,111,239
Young,24,U.S. Senate,,DEM,Edward Kimbrough,4,3,2,9
Young,24,U.S. Senate,,DEM,Beto O'Rourke,6,6,16,28
Young,24,U.S. Senate,,DEM,Sema Hernandez,6,0,1,7
Young,24,U.S. House,19,DEM,Miguel Levario,14,8,16,38
Young,24,Governor,,DEM,"Cedric Davis, Sr.",2,2,1,5
Young,24,Governor,,DEM,Joe Mumbach,1,0,0,1
Young,24,Governor,,DEM,Jeffrey Payne,2,1,0,3
Young,24,Governor,,DEM,James Jolly Clark,0,0,0,0
Young,24,Governor,,DEM,Grady Yarbrough,3,1,2,6
Young,24,Governor,,DEM,Tom Wakely,0,0,0,0
Young,24,Governor,,DEM,Andrew White,1,4,9,14
Young,24,Governor,,DEM,Adrian Ocegueda,2,0,0,2
Young,24,Governor,,DEM,Lupe Valdez,5,2,6,13
Young,24,Lieutenant Governor,,DEM,Mike Collier,12,6,14,32
Young,24,Lieutenant Governor,,DEM,Michael Cooper,5,4,4,13
Young,24,Attorney General,,DEM,Justin Nelson,15,9,18,42
Young,24,Comptroller of Public Accounts,,DEM,Tim Mahoney,8,7,11,26
Young,24,Comptroller of Public Accounts,,DEM,Joi Chevalier,9,1,7,17
Young,24,Commissioner of the General Land Office,,DEM,Miguel Suazo,10,6,12,28
Young,24,Commissioner of the General Land Office,,DEM,Tex Morgan,6,3,6,15
Young,24,Commissioner of Agriculture,,DEM,Kim Olson,15,9,17,41
Young,24,Railroad Commissioner,,DEM,Roman McAllen,7,5,10,22
Young,24,Railroad Commissioner,,DEM,Chris Spellmon,9,4,8,21
Young,24,"Justice, Supreme Court, Place 2",,DEM,Steven Kirkland,15,9,17,41
Young,24,"Justice, Supreme Court, Place 4",,DEM,R.K. Sandill,15,9,16,40
Young,24,"Justice, Supreme Court, Place 6",,DEM,Kathy Cheng,15,9,17,41
Young,24,"Presiding Judge, Court of Criminal Appeals",,DEM,Maria T. (Terri) Jackson,15,9,16,40
Young,24,"Judge, Court of Criminal Appeals, Place 7",,DEM,Ramona Franklin,15,8,17,40
Young,24,State Senator,30,DEM,Kevin Lopez,15,8,16,39
Young,24,"Justice, 2nd Court of Appeals District, Place No. 5",,DEM,Delonia A. Watson,15,8,17,40
Young,24,County Chairman,,DEM,Fran Edens,15,9,18,42
Young,24,Proposition #1,,DEM,Yes,17,9,20,46
Young,24,Proposition #1,,DEM,No,0,1,1,2
Young,24,Proposition #2,,DEM,Yes,16,9,21,46
Young,24,Proposition #2,,DEM,No,0,1,0,1
Young,24,Proposition #3,,DEM,Yes,16,9,20,45
Young,24,Proposition #3,,DEM,No,0,1,1,2
Young,24,Proposition #4,,DEM,Yes,16,9,19,44
Young,24,Proposition #4,,DEM,No,0,1,0,1
Young,24,Proposition #5,,DEM,Yes,16,9,18,43
Young,24,Proposition #5,,DEM,No,1,1,2,4
Young,24,Proposition #6,,DEM,Yes,17,10,18,45
Young,24,Proposition #6,,DEM,No,0,0,2,2
Young,24,Proposition #7,,DEM,Yes,17,10,19,46
Young,24,Proposition #7,,DEM,No,0,0,1,1
Young,24,Proposition #8,,DEM,Yes,15,9,16,40
Young,24,Proposition #8,,DEM,No,1,1,4,6
Young,24,Proposition #9,,DEM,Yes,17,9,17,43
Young,24,Proposition #9,,DEM,No,0,1,2,3
Young,24,Proposition #10,,DEM,Yes,17,10,19,46
Young,24,Proposition #10,,DEM,No,0,0,2,2
Young,24,Proposition #11,,DEM,Yes,15,10,18,43
Young,24,Proposition #11,,DEM,No,2,0,2,4
Young,24,Proposition #12,,DEM,Yes,14,10,17,41
Young,24,Proposition #12,,DEM,No,1,0,2,3
Young,24,Proposition 1,,DEM,YES,62,28,81,171
Young,24,Proposition 1,,DEM,NO,33,11,37,81
Young,24,Proposition 2,,DEM,YES,92,40,112,244
Young,24,Proposition 2,,DEM,NO,7,3,9,19
Young,24,Proposition 3,,DEM,YES,92,37,105,234
Young,24,Proposition 3,,DEM,NO,7,6,17,30
Young,24,Proposition 4,,DEM,YES,90,42,113,245
Young,24,Proposition 4,,DEM,NO,9,1,11,21
Young,24,Proposition 5,,DEM,YES,86,34,102,222
Young,24,Proposition 5,,DEM,NO,16,8,22,46
Young,24,Proposition 6,,DEM,YES,99,43,122,264
Young,24,Proposition 6,,DEM,NO,5,0,4,9
Young,24,Proposition 7,,DEM,YES,86,30,97,213
Young,24,Proposition 7,,DEM,NO,17,13,26,56
Young,24,Proposition 8,,DEM,YES,103,42,125,270
Young,24,Proposition 8,,DEM,NO,1,1,2,4
Young,24,Proposition 9,,DEM,YES,95,39,114,248
Young,24,Proposition 9,,DEM,NO,9,3,9,21
Young,24,Proposition 10,,DEM,YES,98,40,118,256
Young,24,Proposition 10,,DEM,NO,4,1,4,9
Young,24,Proposition 11,,DEM,YES,94,37,112,243
Young,24,Proposition 11,,DEM,NO,11,6,12,29